!_TAG_FILE_FORMAT	2	/extended format; --format=1 will not append ;" to lines/
!_TAG_FILE_SORTED	1	/0=unsorted, 1=sorted, 2=foldcase/
!_TAG_OUTPUT_FILESEP	slash	/slash or backslash/
!_TAG_OUTPUT_MODE	u-ctags	/u-ctags or e-ctags/
!_TAG_PROGRAM_AUTHOR	Universal Ctags Team	//
!_TAG_PROGRAM_NAME	Universal Ctags	/Derived from Exuberant Ctags/
!_TAG_PROGRAM_URL	https://ctags.io/	/official site/
!_TAG_PROGRAM_VERSION	0.0.0	/bd612ba/
Animal.act_interval	obj/living/animal/animal.lua	/^function Animal.act_interval(_s, dt)$/;"	f
Animal.cre	obj/living/animal/animal.lua	/^function Animal.cre(pos, prm)$/;"	f
Animal.final	obj/living/animal/animal.lua	/^function Animal.final(_s)$/;"	f
Animal.init	obj/living/animal/animal.lua	/^function Animal.init(_s)$/;"	f
Animal.is_bird	obj/living/animal/animal.lua	/^function Animal.is_bird(_s)$/;"	f
Animal.is_favo	obj/living/animal/animal.lua	/^function Animal.is_favo(_s, o_cls, o_name)$/;"	f
Animal.is_put_dairy	obj/living/animal/animal.lua	/^function Animal.is_put_dairy(_s)$/;"	f
Animal.on_msg	obj/living/animal/animal.lua	/^function Animal.on_msg(_s, msg_id, prm, sender)$/;"	f
Animal.present	obj/living/animal/animal.lua	/^function Animal.present(_s, o_id)$/;"	f
Animal.upd	obj/living/animal/animal.lua	/^function Animal.upd(_s, dt)$/;"	f
Arw.act_interval	obj/itm/itm/arw/arw.lua	/^function Arw.act_interval(_s, dt)$/;"	f
Arw.init	obj/itm/itm/arw/arw.lua	/^function Arw.init(_s)$/;"	f
Arw.on_msg	obj/itm/itm/arw/arw.lua	/^function Arw.on_msg(_s, msg_id, prm, sender)$/;"	f
Arw.upd	obj/itm/itm/arw/arw.lua	/^function Arw.upd(_s, dt)$/;"	f
Bg.bg_mv_scl	map/lua/bg.lua	/^function Bg.bg_mv_scl(_s)$/;"	f
Bg.bg_mv_scl__d_hrzn	map/lua/bg.lua	/^function Bg.bg_mv_scl__d_hrzn(_s)$/;"	f
Bg.cmr_pos_rate__	map/lua/bg.lua	/^function Bg.cmr_pos_rate__(_s)$/;"	f
Bg.cmr_pos_rng	map/lua/bg.lua	/^function Bg.cmr_pos_rng(_s)$/;"	f
Bg.init	map/lua/bg.lua	/^function Bg.init(_s)$/;"	f
Bg.map_id	map/lua/bg.lua	/^function Bg.map_id(_s)$/;"	f
Bg.map_rng_pos	map/lua/bg.lua	/^function Bg.map_rng_pos(_s)$/;"	f
Bg.map_tilesize	map/lua/bg.lua	/^function Bg.map_tilesize(_s)$/;"	f
Bg.mv_cntr_pos	map/lua/bg.lua	/^function Bg.mv_cntr_pos(_s)$/;"	f
Bg.mv_len	map/lua/bg.lua	/^function Bg.mv_len(_s)$/;"	f
Bg.mv_len_hlf	map/lua/bg.lua	/^function Bg.mv_len_hlf(_s)$/;"	f
Bg.mv_rng_pos	map/lua/bg.lua	/^function Bg.mv_rng_pos(_s)$/;"	f
Bg.mv_rng_pos__c	map/lua/bg.lua	/^function Bg.mv_rng_pos__c(_s)$/;"	f
Bg.mv_rng_pos__d	map/lua/bg.lua	/^function Bg.mv_rng_pos__d(_s)$/;"	f
Bg.mv_rng_pos__d_hrzn	map/lua/bg.lua	/^function Bg.mv_rng_pos__d_hrzn(_s)$/;"	f
Bg.pos__	map/lua/bg.lua	/^function Bg.pos__(_s, pos)$/;"	f
Bg.pos_by_bg_mv_scl	map/lua/bg.lua	/^function Bg.pos_by_bg_mv_scl(_s)$/;"	f
Bg.rng_pos	map/lua/bg.lua	/^function Bg.rng_pos(_s)$/;"	f
Bg.upd	map/lua/bg.lua	/^function Bg.upd(_s, dt)$/;"	f
Bgm.fade_o_ply	etc/sound/bgm/bgm.lua	/^function Bgm.fade_o_ply(bgm_idx)$/;"	f
Bgm.fade_o_ply_rnd	etc/sound/bgm/bgm.lua	/^function Bgm.fade_o_ply_rnd()$/;"	f
Bgm.gain	etc/sound/bgm/bgm.lua	/^function Bgm.gain()$/;"	f
Bgm.gain__	etc/sound/bgm/bgm.lua	/^function Bgm.gain__(gain)$/;"	f
Bgm.gain__fade_o	etc/sound/bgm/bgm.lua	/^function Bgm.gain__fade_o()$/;"	f
Bgm.is_plying	etc/sound/bgm/bgm.lua	/^function Bgm.is_plying()$/;"	f
Bgm.ply	etc/sound/bgm/bgm.lua	/^function Bgm.ply(bgm_idx, gain)$/;"	f
Bgm.ply_nxt	etc/sound/bgm/bgm.lua	/^function Bgm.ply_nxt()$/;"	f
Bgm.ply_rnd	etc/sound/bgm/bgm.lua	/^function Bgm.ply_rnd()$/;"	f
Bgm.plying_bgm	etc/sound/bgm/bgm.lua	/^function Bgm.plying_bgm()$/;"	f
Bgm.plying_idx	etc/sound/bgm/bgm.lua	/^function Bgm.plying_idx()$/;"	f
Bgm.stp	etc/sound/bgm/bgm.lua	/^function Bgm.stp()$/;"	f
Block.act_interval	obj/elm/block/block.lua	/^function Block.act_interval(_s, dt)$/;"	f
Block.cre	obj/elm/block/block.lua	/^function Block.cre(pos, p_tile)$/;"	f
Block.final	obj/elm/block/block.lua	/^function Block.final(_s)$/;"	f
Block.init	obj/elm/block/block.lua	/^function Block.init(_s)$/;"	f
Block.on_msg	obj/elm/block/block.lua	/^function Block.on_msg(_s, msg_id, prm, sender)$/;"	f
Block.trnsf_tile	obj/elm/block/block.lua	/^function Block.trnsf_tile(_s)$/;"	f
Block.upd	obj/elm/block/block.lua	/^function Block.upd(_s, dt)$/;"	f
Bush.act_interval	obj/living/bush/bush.lua	/^function Bush.act_interval(_s, dt)$/;"	f
Bush.cre	obj/living/bush/bush.lua	/^function Bush.cre(pos)$/;"	f
Bush.final	obj/living/bush/bush.lua	/^function Bush.final(_s)$/;"	f
Bush.init	obj/living/bush/bush.lua	/^function Bush.init(_s)$/;"	f
Bush.upd	obj/living/bush/bush.lua	/^function Bush.upd(_s, dt)$/;"	f
Chara.act_interval	obj/chara/chara/chara.lua	/^function Chara.act_interval(_s, dt)$/;"	f
Chara.act_interval__	obj/chara/chara/chara.lua	/^function Chara.act_interval__(_s, dt)$/;"	f
Chara.act_interval_time__	obj/chara/chara/chara.lua	/^function Chara.act_interval_time__(_s)$/;"	f
Chara.cre	obj/chara/chara/chara.lua	/^function Chara.cre(pos, name)$/;"	f
Chara.init	obj/chara/chara/chara.lua	/^function Chara.init(_s, dt)$/;"	f
Chara.is_flyable	obj/chara/chara/chara.lua	/^function Chara.is_flyable(chara)$/;"	f
Chara.kzn__pls	obj/chara/chara/chara.lua	/^function Chara.kzn__pls(_s, point)$/;"	f
Chara.new_name	obj/chara/chara/chara.lua	/^function Chara.new_name()$/;"	f
Chara.on_msg	obj/chara/chara/chara.lua	/^function Chara.on_msg(_s, msg_id, prm, sender)$/;"	f
Chara.upd	obj/chara/chara/chara.lua	/^function Chara.upd(_s, dt)$/;"	f
Cloud.act_interval	obj/elm/cloud/cloud.lua	/^function Cloud.act_interval(_s, dt)$/;"	f
Cloud.cre	obj/elm/cloud/cloud.lua	/^function Cloud.cre(pos, prm)$/;"	f
Cloud.final	obj/elm/cloud/cloud.lua	/^function Cloud.final(_s)$/;"	f
Cloud.init	obj/elm/cloud/cloud.lua	/^function Cloud.init(_s)$/;"	f
Cloud.on_msg	obj/elm/cloud/cloud.lua	/^function Cloud.on_msg(_s, msg_id, prm, sender)$/;"	f
Cloud.upd	obj/elm/cloud/cloud.lua	/^function Cloud.upd(_s, dt)$/;"	f
Cls._	etc/lua/cls.lua	/^function Cls._(cls)$/;"	f
Cls.add	etc/lua/cls.lua	/^function Cls.add(p_Cls, ha_add_by)$/;"	f
Cmr.__dstrct_ch	etc/cmr/cmr.lua	/^function Cmr.__dstrct_ch(_s)$/;"	f
Cmr.__game_start	etc/cmr/cmr.lua	/^function Cmr.__game_start(_s)$/;"	f
Cmr.__stp	etc/cmr/cmr.lua	/^function Cmr.__stp(_s)$/;"	f
Cmr.accl__	etc/cmr/cmr.lua	/^function Cmr.accl__(_s, accl)$/;"	f
Cmr.cre	etc/cmr/cmr.lua	/^function Cmr.cre(pos)$/;"	f
Cmr.final	etc/cmr/cmr.lua	/^function Cmr.final(_s)$/;"	f
Cmr.game_id	etc/cmr/cmr.lua	/^function Cmr.game_id(_s)$/;"	f
Cmr.init	etc/cmr/cmr.lua	/^function Cmr.init(_s)$/;"	f
Cmr.map_rng_pos	etc/cmr/cmr.lua	/^function Cmr.map_rng_pos(_s)$/;"	f
Cmr.on_msg	etc/cmr/cmr.lua	/^function Cmr.on_msg(_s, msg_id, prm, sender)$/;"	f
Cmr.plychara_id	etc/cmr/cmr.lua	/^function Cmr.plychara_id(_s)$/;"	f
Cmr.plychara_pos	etc/cmr/cmr.lua	/^function Cmr.plychara_pos(_s)$/;"	f
Cmr.pos	etc/cmr/cmr.lua	/^function Cmr.pos(_s)$/;"	f
Cmr.pos__	etc/cmr/cmr.lua	/^function Cmr.pos__(_s, pos)$/;"	f
Cmr.pos__dflt	etc/cmr/cmr.lua	/^function Cmr.pos__dflt(_s)$/;"	f
Cmr.pos__far	etc/cmr/cmr.lua	/^function Cmr.pos__far(_s)$/;"	f
Cmr.pos__plychara	etc/cmr/cmr.lua	/^function Cmr.pos__plychara(_s)$/;"	f
Cmr.pos_crct	etc/cmr/cmr.lua	/^function Cmr.pos_crct(_s, pos)$/;"	f
Cmr.pos_crct_x_df	etc/cmr/cmr.lua	/^function Cmr.pos_crct_x_df(_s, z)$/;"	f
Cmr.speed__	etc/cmr/cmr.lua	/^function Cmr.speed__(_s, speed)$/;"	f
Cmr.target_pos	etc/cmr/cmr.lua	/^function Cmr.target_pos(_s)$/;"	f
Cmr.target_pos__	etc/cmr/cmr.lua	/^function Cmr.target_pos__(_s, pos)$/;"	f
Cmr.target_z	etc/cmr/cmr.lua	/^function Cmr.target_z(_s)$/;"	f
Cmr.upd	etc/cmr/cmr.lua	/^function Cmr.upd(_s, dt)$/;"	f
Cmr.upd_pos	etc/cmr/cmr.lua	/^function Cmr.upd_pos(_s, dt)$/;"	f
Cmr.upd_target_pos__	etc/cmr/cmr.lua	/^function Cmr.upd_target_pos__(_s)$/;"	f
Cmr.upd_target_pos_x_df	etc/cmr/cmr.lua	/^function Cmr.upd_target_pos_x_df(_s, dt, z)$/;"	f
Cmr.upd_vec	etc/cmr/cmr.lua	/^function Cmr.upd_vec(_s, dt)$/;"	f
Cmr.upd_vec_far	etc/cmr/cmr.lua	/^function Cmr.upd_vec_far(_s, dt)$/;"	f
Cmr.upd_vec_far_frnt	etc/cmr/cmr.lua	/^function Cmr.upd_vec_far_frnt(_s, dt)$/;"	f
Cmr.upd_vec_far_out	etc/cmr/cmr.lua	/^function Cmr.upd_vec_far_out(_s, dt)$/;"	f
Cmr.upd_vec_near	etc/cmr/cmr.lua	/^function Cmr.upd_vec_near(_s, dt)$/;"	f
Cmr.z	etc/cmr/cmr.lua	/^function Cmr.z(_s)$/;"	f
Cmr.z__	etc/cmr/cmr.lua	/^function Cmr.z__(_s, z)$/;"	f
Cmr.z__far	etc/cmr/cmr.lua	/^function Cmr.z__far(_s)$/;"	f
Cmr.zoom__anm	etc/cmr/cmr.lua	/^function Cmr.zoom__anm(_s, time)$/;"	f
Cmr.zoom__dflt	etc/cmr/cmr.lua	/^function Cmr.zoom__dflt(_s)$/;"	f
Cmr.zoom__far	etc/cmr/cmr.lua	/^function Cmr.zoom__far(_s, time)$/;"	f
Cmr.zoom__i	etc/cmr/cmr.lua	/^function Cmr.zoom__i(_s)$/;"	f
Cmr.zoom__o	etc/cmr/cmr.lua	/^function Cmr.zoom__o(_s)$/;"	f
D._	etc/d/d.lua	/^function D._(txt)$/;"	f
D.c	etc/d/d.lua	/^function D.c(chara)$/;"	f
D.o	etc/d/d.lua	/^function D.o(txt)$/;"	f
D.txt__add	etc/d/d.lua	/^function D.txt__add(txt)$/;"	f
D.txt__del_1	etc/d/d.lua	/^function D.txt__del_1()$/;"	f
Dairy.act_interval	obj/itm/food/dairy/dairy.lua	/^function Dairy.act_interval(_s, dt)$/;"	f
Dairy.cre	obj/itm/food/dairy/dairy.lua	/^function Dairy.cre(pos, prm)$/;"	f
Dairy.init	obj/itm/food/dairy/dairy.lua	/^function Dairy.init(_s)$/;"	f
Dairy.upd	obj/itm/food/dairy/dairy.lua	/^function Dairy.upd(_s, dt)$/;"	f
Dish.act_interval	obj/itm/food/dish/dish.lua	/^function Dish.act_interval(_s, dt)$/;"	f
Dish.cre	obj/itm/food/dish/dish.lua	/^function Dish.cre(pos, prm)$/;"	f
Dish.init	obj/itm/food/dish/dish.lua	/^function Dish.init(_s)$/;"	f
Dish.upd	obj/itm/food/dish/dish.lua	/^function Dish.upd(_s, dt)$/;"	f
Door.act_interval	obj/itm/kagu/door/door.lua	/^function Door.act_interval(_s, dt)$/;"	f
Door.cre	obj/itm/kagu/door/door.lua	/^function Door.cre(pos, prm)$/;"	f
Door.final	obj/itm/kagu/door/door.lua	/^function Door.final(_s)$/;"	f
Door.init	obj/itm/kagu/door/door.lua	/^function Door.init(_s)$/;"	f
Door.on_msg	obj/itm/kagu/door/door.lua	/^function Door.on_msg(_s, msg_id, prm, sender)$/;"	f
Door.opn	obj/itm/kagu/door/door.lua	/^function Door.opn(_s)$/;"	f
Door.upd	obj/itm/kagu/door/door.lua	/^function Door.upd(_s, dt)$/;"	f
Dryleaf.act_interval	obj/itm/wood/dryleaf/dryleaf.lua	/^function Dryleaf.act_interval(_s, dt)$/;"	f
Dryleaf.cre	obj/itm/wood/dryleaf/dryleaf.lua	/^function Dryleaf.cre(pos)$/;"	f
Dryleaf.final	obj/itm/wood/dryleaf/dryleaf.lua	/^function Dryleaf.final(_s)$/;"	f
Dryleaf.init	obj/itm/wood/dryleaf/dryleaf.lua	/^function Dryleaf.init(_s)$/;"	f
Dryleaf.upd	obj/itm/wood/dryleaf/dryleaf.lua	/^function Dryleaf.upd(_s, dt)$/;"	f
Egg.act_interval	obj/itm/food/egg/egg.lua	/^function Egg.act_interval(_s, dt)$/;"	f
Egg.cre	obj/itm/food/egg/egg.lua	/^function Egg.cre(pos, prm)$/;"	f
Egg.init	obj/itm/food/egg/egg.lua	/^function Egg.init(_s)$/;"	f
Egg.upd	obj/itm/food/egg/egg.lua	/^function Egg.upd(_s, dt)$/;"	f
Emtn.act_interval	obj/chara/emtn/emtn.lua	/^function Emtn.act_interval(_s, dt)$/;"	f
Emtn.cre	obj/chara/emtn/emtn.lua	/^function Emtn.cre(pos, emtnnum)$/;"	f
Emtn.init	obj/chara/emtn/emtn.lua	/^function Emtn.init(_s)$/;"	f
Emtn.upd	obj/chara/emtn/emtn.lua	/^function Emtn.upd(_s, dt)$/;"	f
Ev._	etc/ev/ev/ev.lua	/^function Ev._(name)$/;"	f
Ev._do	etc/ev/ev/ev.lua	/^function Ev._do(_s)$/;"	f
Ev._start	etc/ev/ev/ev.lua	/^function Ev._start(_s)$/;"	f
Ev._wa_inp	etc/ev/ev/ev.lua	/^function Ev._wa_inp(_s)$/;"	f
Ev._wa_inp_fin	etc/ev/ev/ev.lua	/^function Ev._wa_inp_fin(_s)$/;"	f
Ev._wa_sec	etc/ev/ev/ev.lua	/^function Ev._wa_sec(_s)$/;"	f
Ev._wa_sec_fin	etc/ev/ev/ev.lua	/^function Ev._wa_sec_fin(_s)$/;"	f
Ev.cre	etc/ev/ev/ev.lua	/^function Ev.cre()$/;"	f
Ev.fin	etc/ev/ev/ev.lua	/^function Ev.fin()$/;"	f
Ev.init	etc/ev/ev/ev.lua	/^function Ev.init(_s)$/;"	f
Ev.on_msg	etc/ev/ev/ev.lua	/^function Ev.on_msg(_s, msg_id, prm, sender)$/;"	f
Fairy.cre	obj/elm/fairy/fairy.lua	/^function Fairy.cre(pos, prm)$/;"	f
Fairy.del	obj/elm/fairy/fairy.lua	/^function Fairy.del()$/;"	f
Fairy.init	obj/elm/fairy/fairy.lua	/^function Fairy.init(_s)$/;"	f
Fairy.on_msg	obj/elm/fairy/fairy.lua	/^function Fairy.on_msg(_s, msg_id, prm, sender)$/;"	f
Fairy.upd	obj/elm/fairy/fairy.lua	/^function Fairy.upd(_s, dt)$/;"	f
Fg.add	map/lua/fg.lua	/^function Fg.add(p_tilemap, area, p_id)$/;"	f
Fg.init	map/lua/fg.lua	/^function Fg.init(_s)$/;"	f
Fg.on_msg	map/lua/fg.lua	/^function Fg.on_msg(_s, msg_id, prm, sender)$/;"	f
Fg.upd	map/lua/fg.lua	/^function Fg.upd(_s, dt)$/;"	f
Fire.act_interval	obj/elm/fire/fire.lua	/^function Fire.act_interval(_s, dt)$/;"	f
Fire.burn	obj/elm/fire/fire.lua	/^function Fire.burn(_s)$/;"	f
Fire.burn_obj	obj/elm/fire/fire.lua	/^function Fire.burn_obj(_s)$/;"	f
Fire.burn_tile	obj/elm/fire/fire.lua	/^function Fire.burn_tile(_s)$/;"	f
Fire.cre	obj/elm/fire/fire.lua	/^function Fire.cre(pos)$/;"	f
Fire.final	obj/elm/fire/fire.lua	/^function Fire.final(_s)$/;"	f
Fire.init	obj/elm/fire/fire.lua	/^function Fire.init(_s)$/;"	f
Fire.upd	obj/elm/fire/fire.lua	/^function Fire.upd(_s, dt)$/;"	f
Fish.act_interval	obj/itm/food/fish/fish.lua	/^function Fish.act_interval(_s, dt)$/;"	f
Fish.cre	obj/itm/food/fish/fish.lua	/^function Fish.cre(pos, prm)$/;"	f
Fish.init	obj/itm/food/fish/fish.lua	/^function Fish.init(_s)$/;"	f
Fish.upd	obj/itm/food/fish/fish.lua	/^function Fish.upd(_s, dt)$/;"	f
Flower.act_interval	obj/living/flower/flower.lua	/^function Flower.act_interval(_s, dt)$/;"	f
Flower.cre	obj/living/flower/flower.lua	/^function Flower.cre(pos, prm)$/;"	f
Flower.final	obj/living/flower/flower.lua	/^function Flower.final(_s)$/;"	f
Flower.init	obj/living/flower/flower.lua	/^function Flower.init(_s)$/;"	f
Flower.on_msg	obj/living/flower/flower.lua	/^function Flower.on_msg(_s, msg_id, prm, sender)$/;"	f
Flower.upd	obj/living/flower/flower.lua	/^function Flower.upd(_s, dt)$/;"	f
Flpy.act_interval	obj/itm/kagu/flpy/flpy.lua	/^function Flpy.act_interval(_s, dt)$/;"	f
Flpy.cre	obj/itm/kagu/flpy/flpy.lua	/^function Flpy.cre(pos, prm)$/;"	f
Flpy.final	obj/itm/kagu/flpy/flpy.lua	/^function Flpy.final(_s)$/;"	f
Flpy.init	obj/itm/kagu/flpy/flpy.lua	/^function Flpy.init(_s)$/;"	f
Flpy.on_msg	obj/itm/kagu/flpy/flpy.lua	/^function Flpy.on_msg(_s, msg_id, prm, sender)$/;"	f
Flpy.opn	obj/itm/kagu/flpy/flpy.lua	/^function Flpy.opn(_s)$/;"	f
Flpy.upd	obj/itm/kagu/flpy/flpy.lua	/^function Flpy.upd(_s, dt)$/;"	f
Fluff.act_interval	obj/living/fluff/fluff.lua	/^function Fluff.act_interval(_s, dt)$/;"	f
Fluff.cre	obj/living/fluff/fluff.lua	/^function Fluff.cre(pos, prm)$/;"	f
Fluff.final	obj/living/fluff/fluff.lua	/^function Fluff.final(_s)$/;"	f
Fluff.init	obj/living/fluff/fluff.lua	/^function Fluff.init(_s)$/;"	f
Fluff.on_msg	obj/living/fluff/fluff.lua	/^function Fluff.on_msg(_s, msg_id, prm, sender)$/;"	f
Fluff.upd	obj/living/fluff/fluff.lua	/^function Fluff.upd(_s, dt)$/;"	f
Food.bear_o	obj/itm/food/food.lua	/^function Food.bear_o(_s, tree_id)$/;"	f
Food.bear_x	obj/itm/food/food.lua	/^function Food.bear_x(_s)$/;"	f
Food.cook_to_dish	obj/itm/food/food.lua	/^function Food.cook_to_dish(_s)$/;"	f
Food.cre_by_cls	obj/itm/food/food.lua	/^function Food.cre_by_cls(pos, prm)$/;"	f
Food.final	obj/itm/food/food.lua	/^function Food.final(_s)$/;"	f
Food.init	obj/itm/food/food.lua	/^function Food.init(_s)$/;"	f
Food.into_reizoko	obj/itm/food/food.lua	/^function Food.into_reizoko(_s, reizoko_id)$/;"	f
Food.kitchen_o	obj/itm/food/food.lua	/^function Food.kitchen_o(_s, kitchen_id)$/;"	f
Food.kitchen_x	obj/itm/food/food.lua	/^function Food.kitchen_x(_s)$/;"	f
Food.on_kitchen	obj/itm/food/food.lua	/^function Food.on_kitchen(_s, kitchen_id) -- old$/;"	f
Food.on_kitchen_false	obj/itm/food/food.lua	/^function Food.on_kitchen_false(_s) -- old$/;"	f
Food.on_msg	obj/itm/food/food.lua	/^function Food.on_msg(_s, msg_id, prm, sender)$/;"	f
Food.take_kitchen	obj/itm/food/food.lua	/^function Food.take_kitchen(_s) -- old$/;"	f
Food.take_reizoko	obj/itm/food/food.lua	/^function Food.take_reizoko(_s)$/;"	f
Fruit.act_interval	obj/itm/food/fruit/fruit.lua	/^function Fruit.act_interval(_s, dt)$/;"	f
Fruit.cre	obj/itm/food/fruit/fruit.lua	/^function Fruit.cre(pos, prm, scl)$/;"	f
Fruit.init	obj/itm/food/fruit/fruit.lua	/^function Fruit.init(_s)$/;"	f
Fruit.upd	obj/itm/food/fruit/fruit.lua	/^function Fruit.upd(_s, dt)$/;"	f
Fuki._s	obj/chara/fuki/fuki/fuki.lua	/^function Fuki._s(_s, str, len)$/;"	f
Fuki.act_interval	obj/chara/fuki/fuki/fuki.lua	/^function Fuki.act_interval(_s, dt)$/;"	f
Fuki.cre	obj/chara/fuki/fuki/fuki.lua	/^function Fuki.cre(pos, prm, scl)$/;"	f
Fuki.init	obj/chara/fuki/fuki/fuki.lua	/^function Fuki.init(_s)$/;"	f
Fuki.on_msg	obj/chara/fuki/fuki/fuki.lua	/^function Fuki.on_msg(_s, msg_id, prm, sender)$/;"	f
Fuki.upd	obj/chara/fuki/fuki/fuki.lua	/^function Fuki.upd(_s, dt)$/;"	f
Game.act_interval	sys/sq/game/game.lua	/^function Game.act_interval(_s, dt)$/;"	f
Game.act_interval__	sys/sq/game/game.lua	/^function Game.act_interval__(_s, dt)$/;"	f
Game.bag_opn	sys/sq/game/game.lua	/^function Game.bag_opn(_s)$/;"	f
Game.bgm_ply_nxt_rnd	sys/sq/game/game.lua	/^function Game.bgm_ply_nxt_rnd(_s)$/;"	f
Game.bgm_ply_rnd	sys/sq/game/game.lua	/^function Game.bgm_ply_rnd(_s)$/;"	f
Game.cloud_id	sys/sq/game/game.lua	/^function Game.cloud_id()$/;"	f
Game.cloud_pos	sys/sq/game/game.lua	/^function Game.cloud_pos()$/;"	f
Game.cmr_pos__init	sys/sq/game/game.lua	/^function Game.cmr_pos__init(_s)$/;"	f
Game.continue	sys/sq/game/game.lua	/^function Game.continue(_s, ply_data_file_idx)$/;"	f
Game.cre	sys/sq/game/game.lua	/^function Game.cre(ply_slt_idx)$/;"	f
Game.cre_continue	sys/sq/game/game.lua	/^function Game.cre_continue(ply_slt_idx, ply_data_file_idx)$/;"	f
Game.cre_new	sys/sq/game/game.lua	/^function Game.cre_new(ply_slt_idx)$/;"	f
Game.del	sys/sq/game/game.lua	/^function Game.del(_s)$/;"	f
Game.dstrct	sys/sq/game/game.lua	/^function Game.dstrct()$/;"	f
Game.final	sys/sq/game/game.lua	/^function Game.final(_s)$/;"	f
Game.id	sys/sq/game/game.lua	/^function Game.id()$/;"	f
Game.init	sys/sq/game/game.lua	/^function Game.init(_s)$/;"	f
Game.is_loop__act_interval__	sys/sq/game/game.lua	/^function Game.is_loop__act_interval__(_s, dt)$/;"	f
Game.is_map_pause	sys/sq/game/game.lua	/^function Game.is_map_pause(_s)$/;"	f
Game.map__cre	sys/sq/game/game.lua	/^function Game.map__cre(_s, dstrct)$/;"	f
Game.map__del	sys/sq/game/game.lua	/^function Game.map__del(_s)$/;"	f
Game.map__save	sys/sq/game/game.lua	/^function Game.map__save(_s)$/;"	f
Game.map__save_del	sys/sq/game/game.lua	/^function Game.map__save_del(_s)$/;"	f
Game.map_clct	sys/sq/game/game.lua	/^function Game.map_clct(p_dstrct)$/;"	f
Game.map_cloud__cre	sys/sq/game/game.lua	/^function Game.map_cloud__cre(_s)$/;"	f
Game.map_dstrct__ch	sys/sq/game/game.lua	/^function Game.map_dstrct__ch(_s, dstrct, plychara)$/;"	f
Game.map_dstrct__ch_map_cre	sys/sq/game/game.lua	/^function Game.map_dstrct__ch_map_cre(_s)$/;"	f
Game.map_dstrct__ch_tmp__	sys/sq/game/game.lua	/^function Game.map_dstrct__ch_tmp__(_s, dstrct, plychara)$/;"	f
Game.map_dstrct__ch_tmp__clr	sys/sq/game/game.lua	/^function Game.map_dstrct__ch_tmp__clr(_s, dstrct, plychara)$/;"	f
Game.map_dstrct__mv	sys/sq/game/game.lua	/^function Game.map_dstrct__mv(_s, dir, plychara_dir) -- dir : u d l r$/;"	f
Game.map_dstrct__mv_h	sys/sq/game/game.lua	/^function Game.map_dstrct__mv_h(_s, dir, plychara_dir) -- dir : l r$/;"	f
Game.map_dstrct__mv_v	sys/sq/game/game.lua	/^function Game.map_dstrct__mv_v(_s, dir, plychara_dir) -- dir : u d$/;"	f
Game.map_fairy__cre	sys/sq/game/game.lua	/^function Game.map_fairy__cre(_s)$/;"	f
Game.map_id	sys/sq/game/game.lua	/^function Game.map_id()$/;"	f
Game.map_plychara__cre	sys/sq/game/game.lua	/^function Game.map_plychara__cre(_s, pos)$/;"	f
Game.map_rng_pos	sys/sq/game/game.lua	/^function Game.map_rng_pos()$/;"	f
Game.new	sys/sq/game/game.lua	/^function Game.new(_s)$/;"	f
Game.new_event	sys/sq/game/game.lua	/^function Game.new_event(_s)$/;"	f
Game.on_msg	sys/sq/game/game.lua	/^function Game.on_msg(_s, msg_id, prm, sender)$/;"	f
Game.ply_data__load	sys/sq/game/game.lua	/^function Game.ply_data__load(_s, ply_data_file_idx)$/;"	f
Game.ply_data__new	sys/sq/game/game.lua	/^function Game.ply_data__new(_s)$/;"	f
Game.ply_data__save	sys/sq/game/game.lua	/^function Game.ply_data__save(_s)$/;"	f
Game.ply_slt_idx	sys/sq/game/game.lua	/^function Game.ply_slt_idx()$/;"	f
Game.plychara_dir	sys/sq/game/game.lua	/^function Game.plychara_dir()$/;"	f
Game.plychara_id	sys/sq/game/game.lua	/^function Game.plychara_id()$/;"	f
Game.plychara_pos	sys/sq/game/game.lua	/^function Game.plychara_pos()$/;"	f
Game.save	sys/sq/game/game.lua	/^function Game.save(_s)$/;"	f
Game.sky__cre	sys/sq/game/game.lua	/^function Game.sky__cre(_s)$/;"	f
Game.sky__del	sys/sq/game/game.lua	/^function Game.sky__del(_s)$/;"	f
Game.sky_id	sys/sq/game/game.lua	/^function Game.sky_id(_s)$/;"	f
Game.sky_idx	sys/sq/game/game.lua	/^function Game.sky_idx(_s)$/;"	f
Game.upd	sys/sq/game/game.lua	/^function Game.upd(_s, dt)$/;"	f
Gold.cre	obj/itm/gold/gold.lua	/^function Gold.cre(pos, prm)$/;"	f
Gold.final	obj/itm/gold/gold.lua	/^function Gold.final(_s)$/;"	f
Gold.init	obj/itm/gold/gold.lua	/^function Gold.init(_s)$/;"	f
Gold.on_msg	obj/itm/gold/gold.lua	/^function Gold.on_msg(_s, msg_id, prm, sender)$/;"	f
Gold.upd	obj/itm/gold/gold.lua	/^function Gold.upd(_s, dt)$/;"	f
Grave.act_interval	obj/living/phantom/grave/grave.lua	/^function Grave.act_interval(_s, dt)$/;"	f
Grave.cre	obj/living/phantom/grave/grave.lua	/^function Grave.cre(pos, prm)$/;"	f
Grave.final	obj/living/phantom/grave/grave.lua	/^function Grave.final(_s)$/;"	f
Grave.init	obj/living/phantom/grave/grave.lua	/^function Grave.init(_s)$/;"	f
Grave.on_msg	obj/living/phantom/grave/grave.lua	/^function Grave.on_msg(_s, msg_id, prm, sender)$/;"	f
Grave.upd	obj/living/phantom/grave/grave.lua	/^function Grave.upd(_s, dt)$/;"	f
Gui_inp.cre	gui/inp/inp.lua	/^function Gui_inp.cre()$/;"	f
Gui_inp.init	gui/inp/inp.lua	/^function Gui_inp.init(_s)$/;"	f
Gui_inp.is_focus	gui/inp/inp.lua	/^function Gui_inp.is_focus()$/;"	f
Gui_inp.on_inp	gui/inp/inp.lua	/^function Gui_inp.on_inp(_s, key, keyact)$/;"	f
Gui_inp.on_inp_keyact__	gui/inp/inp.lua	/^function Gui_inp.on_inp_keyact__(_s, key, keyact)$/;"	f
Gui_inp.on_inp_v3	gui/inp/inp.lua	/^function Gui_inp.on_inp_v3(_s, key, keyact)$/;"	f
Gui_inp.on_msg	gui/inp/inp.lua	/^function Gui_inp.on_msg(_s, msg_id, prm, sender)$/;"	f
Holdable.final	obj/obj/holdable.lua	/^function Holdable.final(_s)$/;"	f
Holdable.hold__o	obj/obj/holdable.lua	/^function Holdable.hold__o(_s, prm)$/;"	f
Holdable.hold__x	obj/obj/holdable.lua	/^function Holdable.hold__x(_s)$/;"	f
Holdable.hold_pos	obj/obj/holdable.lua	/^function Holdable.hold_pos(_s)$/;"	f
Holdable.hold_pos__	obj/obj/holdable.lua	/^function Holdable.hold_pos__(_s, p_pos)$/;"	f
Holdable.init	obj/obj/holdable.lua	/^function Holdable.init(_s)$/;"	f
Holdable.on_msg	obj/obj/holdable.lua	/^function Holdable.on_msg(_s, msg_id, prm, sender)$/;"	f
Hrvst.act_interval	obj/itm/kagu/hrvst/hrvst.lua	/^function Hrvst.act_interval(_s, dt)$/;"	f
Hrvst.box_in	obj/itm/kagu/hrvst/hrvst.lua	/^function Hrvst.box_in(_s, prm)$/;"	f
Hrvst.cre	obj/itm/kagu/hrvst/hrvst.lua	/^function Hrvst.cre(pos)$/;"	f
Hrvst.final	obj/itm/kagu/hrvst/hrvst.lua	/^function Hrvst.final(_s)$/;"	f
Hrvst.init	obj/itm/kagu/hrvst/hrvst.lua	/^function Hrvst.init(_s)$/;"	f
Hrvst.on_msg	obj/itm/kagu/hrvst/hrvst.lua	/^function Hrvst.on_msg(_s, msg_id, prm, sender)$/;"	f
Hrvst.upd	obj/itm/kagu/hrvst/hrvst.lua	/^function Hrvst.upd(_s, dt)$/;"	f
Humus.act_interval	obj/elm/humus/humus.lua	/^function Humus.act_interval(_s, dt)$/;"	f
Humus.cre	obj/elm/humus/humus.lua	/^function Humus.cre(pos)$/;"	f
Humus.final	obj/elm/humus/humus.lua	/^function Humus.final(_s)$/;"	f
Humus.init	obj/elm/humus/humus.lua	/^function Humus.init(_s)$/;"	f
Humus.upd	obj/elm/humus/humus.lua	/^function Humus.upd(_s, dt)$/;"	f
Inp.__	etc/lua/inp.lua	/^function Inp.__(i, key, keyact)$/;"	f
Inp._is_key_act	etc/lua/inp.lua	/^function Inp._is_key_act(i, key, act)$/;"	f
Inp._upd_dec_chain_limit	etc/lua/inp.lua	/^function Inp._upd_dec_chain_limit(i, dt)$/;"	f
Inp._upd_inc_long	etc/lua/inp.lua	/^function Inp._upd_inc_long(i, dt)$/;"	f
Inp.arwHa_2_inp_dir	etc/lua/inp.lua	/^function Inp.arwHa_2_inp_dir(key) -- key:hash$/;"	f
Inp.cc	etc/lua/inp.lua	/^function Inp.cc(i, key) -- get chain count$/;"	f
Inp.ccWithin	etc/lua/inp.lua	/^function Inp.ccWithin(i, key, cnt) -- success cnt + is possible chain$/;"	f
Inp.f	etc/lua/inp.lua	/^function Inp.f(i, key) -- release -> free$/;"	f
Inp.init	etc/lua/inp.lua	/^function Inp.init(_s)$/;"	f
Inp.k	etc/lua/inp.lua	/^function Inp.k(i, key) -- press keep$/;"	f
Inp.key_by_ha	etc/lua/inp.lua	/^function Inp.key_by_ha(keyHa)$/;"	f
Inp.l	etc/lua/inp.lua	/^function Inp.l(i, key) -- press long$/;"	f
Inp.next	etc/lua/inp.lua	/^function Inp.next(i)$/;"	f
Inp.on_input_player	etc/lua/inp.lua	/^function Inp.on_input_player(i)$/;"	f
Inp.p	etc/lua/inp.lua	/^function Inp.p(i, key) -- press$/;"	f
Inp.upd	etc/lua/inp.lua	/^function Inp.upd(_s, dt)$/;"	f
Inp.with	etc/lua/inp.lua	/^function Inp.with(i, key) -- key keep and ...$/;"	f
Inp.with_k	etc/lua/inp.lua	/^function Inp.with_k(i, key1, key2) -- key1 keep and key2 keep$/;"	f
Inp.with_p	etc/lua/inp.lua	/^function Inp.with_p(i, key1, key2) -- key1 keep and key2 press$/;"	f
Inp.within	etc/lua/inp.lua	/^function Inp.within(i, key) -- within$/;"	f
Kagu.act_interval	obj/itm/kagu/kagu/kagu.lua	/^function Kagu.act_interval(_s, dt)$/;"	f
Kagu.cre	obj/itm/kagu/kagu/kagu.lua	/^function Kagu.cre(pos, prm)$/;"	f
Kagu.final	obj/itm/kagu/kagu/kagu.lua	/^function Kagu.final(_s)$/;"	f
Kagu.init	obj/itm/kagu/kagu/kagu.lua	/^function Kagu.init(_s)$/;"	f
Kagu.on_msg	obj/itm/kagu/kagu/kagu.lua	/^function Kagu.on_msg(_s, msg_id, prm, sender)$/;"	f
Kagu.upd	obj/itm/kagu/kagu/kagu.lua	/^function Kagu.upd(_s, dt)$/;"	f
Kitchen._cre_dish	obj/itm/kagu/kitchen/kitchen.lua	/^function Kitchen._cre_dish(_s)$/;"	f
Kitchen._food_pos__	obj/itm/kagu/kitchen/kitchen.lua	/^function Kitchen._food_pos__(_s)$/;"	f
Kitchen.cooking_start	obj/itm/kagu/kitchen/kitchen.lua	/^function Kitchen.cooking_start(_s)$/;"	f
Kitchen.cre	obj/itm/kagu/kitchen/kitchen.lua	/^function Kitchen.cre(pos, prm)$/;"	f
Kitchen.final	obj/itm/kagu/kitchen/kitchen.lua	/^function Kitchen.final(_s)$/;"	f
Kitchen.init	obj/itm/kagu/kitchen/kitchen.lua	/^function Kitchen.init(_s)$/;"	f
Kitchen.kitchen_o	obj/itm/kagu/kitchen/kitchen.lua	/^function Kitchen.kitchen_o(_s, food_id)$/;"	f
Kitchen.kitchen_x	obj/itm/kagu/kitchen/kitchen.lua	/^function Kitchen.kitchen_x(_s, food_id)$/;"	f
Kitchen.log	obj/itm/kagu/kitchen/kitchen.lua	/^function Kitchen.log(_s)$/;"	f
Kitchen.on_kitchen	obj/itm/kagu/kitchen/kitchen.lua	/^function Kitchen.on_kitchen(_s, food_id) -- old$/;"	f
Kitchen.on_msg	obj/itm/kagu/kitchen/kitchen.lua	/^function Kitchen.on_msg(_s, msg_id, prm, sender)$/;"	f
Kitchen.take_kitchen	obj/itm/kagu/kitchen/kitchen.lua	/^function Kitchen.take_kitchen(_s, food_id) -- old$/;"	f
Kitchen.upd	obj/itm/kagu/kitchen/kitchen.lua	/^function Kitchen.upd(_s, dt)$/;"	f
Kitchen.upd_cooking	obj/itm/kagu/kitchen/kitchen.lua	/^function Kitchen.upd_cooking(_s)$/;"	f
Kitchen.upd_cooking_timer	obj/itm/kagu/kitchen/kitchen.lua	/^function Kitchen.upd_cooking_timer(_s, dt) -- dec$/;"	f
Leaf.act_interval	obj/itm/wood/leaf/leaf.lua	/^function Leaf.act_interval(_s, dt)$/;"	f
Leaf.cre	obj/itm/wood/leaf/leaf.lua	/^function Leaf.cre(pos)$/;"	f
Leaf.final	obj/itm/wood/leaf/leaf.lua	/^function Leaf.final(_s)$/;"	f
Leaf.init	obj/itm/wood/leaf/leaf.lua	/^function Leaf.init(_s)$/;"	f
Leaf.upd	obj/itm/wood/leaf/leaf.lua	/^function Leaf.upd(_s, dt)$/;"	f
Livingmove.init	obj/living/livingmove.lua	/^function Livingmove.init(_s)$/;"	f
Livingmove.is_moving	obj/living/livingmove.lua	/^function Livingmove.is_moving(_s)$/;"	f
Livingmove.moving__	obj/living/livingmove.lua	/^function Livingmove.moving__(_s, val)$/;"	f
Livingmove.moving__rnd	obj/living/livingmove.lua	/^function Livingmove.moving__rnd(_s)$/;"	f
Livingmove.moving_prp__rnd	obj/living/livingmove.lua	/^function Livingmove.moving_prp__rnd(_s)$/;"	f
Livingmove.speed__	obj/living/livingmove.lua	/^function Livingmove.speed__(_s, speed)$/;"	f
Livingmove.speed__rnd	obj/living/livingmove.lua	/^function Livingmove.speed__rnd(_s)$/;"	f
Livingmove.upd_pos_movable	obj/living/livingmove.lua	/^function Livingmove.upd_pos_movable(_s, dt)$/;"	f
Livingmove.vec_mv	obj/living/livingmove.lua	/^function Livingmove.vec_mv(_s, dt)$/;"	f
Livingmove.vec_mv_living	obj/living/livingmove.lua	/^function Livingmove.vec_mv_living(_s, dt)$/;"	f
Magic.act_interval	obj/elm/magic/magic.lua	/^function Magic.act_interval(_s, dt)$/;"	f
Magic.cre	obj/elm/magic/magic.lua	/^function Magic.cre(pos, tilepos)$/;"	f
Magic.init	obj/elm/magic/magic.lua	/^function Magic.init(_s)$/;"	f
Magic.is_magic_vnsh	obj/elm/magic/magic.lua	/^function Magic.is_magic_vnsh(tile)$/;"	f
Magic.magic_tile	obj/elm/magic/magic.lua	/^function Magic.magic_tile()$/;"	f
Magic.tilepos_by_inp_prm	obj/elm/magic/magic.lua	/^function Magic.tilepos_by_inp_prm(dir_h, prm) -- return tilepos diff$/;"	f
Magic.upd	obj/elm/magic/magic.lua	/^function Magic.upd(_s, dt)$/;"	f
Map.act_interval	map/lua/map.lua	/^function Map.act_interval(_s, dt)$/;"	f
Map.act_interval__	map/lua/map.lua	/^function Map.act_interval__(_s, dt)$/;"	f
Map.add_chara	map/lua/map_obj.lua	/^function Map.add_chara(chara)$/;"	f
Map.arund_tile_bndl_ar	map/lua/map.lua	/^function Map.arund_tile_bndl_ar(p_tilepos, p_tile)$/;"	f
Map.chara_is_appear_all	map/lua/map.lua	/^function Map.chara_is_appear_all()$/;"	f
Map.cloud__cre	map/lua/map_obj.lua	/^function Map.cloud__cre(_s, prm)$/;"	f
Map.cloud_id	map/lua/map.lua	/^function Map.cloud_id(_s)$/;"	f
Map.cmr_pos__plychara	map/lua/map.lua	/^function Map.cmr_pos__plychara(_s)$/;"	f
Map.cnt__clr	map/lua/map.lua	/^function Map.cnt__clr()$/;"	f
Map.cre	map/lua/map.lua	/^function Map.cre(p_clct)$/;"	f
Map.del	map/lua/map.lua	/^function Map.del(_s)$/;"	f
Map.dstrct__ch	map/lua/map.lua	/^function Map.dstrct__ch(_s, plychara)$/;"	f
Map.dstrct_mv_rng_pos__init	map/lua/map.lua	/^function Map.dstrct_mv_rng_pos__init(_s)$/;"	f
Map.fairy__cre	map/lua/map_obj.lua	/^function Map.fairy__cre(_s, pos, prm)$/;"	f
Map.fairy_id	map/lua/map.lua	/^function Map.fairy_id(_s)$/;"	f
Map.final	map/lua/map.lua	/^function Map.final(_s)$/;"	f
Map.game_id	map/lua/map.lua	/^function Map.game_id(_s)$/;"	f
Map.init	map/lua/map.lua	/^function Map.init(_s)$/;"	f
Map.is_loop__act_interval__	map/lua/map.lua	/^function Map.is_loop__act_interval__(_s, dt)$/;"	f
Map.load	map/lua/map.lua	/^function Map.load(_s, file_idx)$/;"	f
Map.new	map/lua/map.lua	/^function Map.new(_s, plychara_pos)$/;"	f
Map.new_or_load	map/lua/map.lua	/^function Map.new_or_load(_s)$/;"	f
Map.not_appear_chara	map/lua/map.lua	/^function Map.not_appear_chara()$/;"	f
Map.obj	map/lua/map_obj.lua	/^function Map.obj(_s)$/;"	f
Map.obj_2_save_data	map/lua/map_obj.lua	/^function Map.obj_2_save_data(_s)$/;"	f
Map.obj__	map/lua/map_obj.lua	/^function Map.obj__(_s, data)$/;"	f
Map.obj__cre_dflt	map/lua/map_obj.lua	/^function Map.obj__cre_dflt() -- not use$/;"	f
Map.obj__new	map/lua/map_obj.lua	/^function Map.obj__new(_s)$/;"	f
Map.obj__new_kagu	map/lua/map_obj.lua	/^function Map.obj__new_kagu(_s)$/;"	f
Map.obj_cls	map/lua/map_obj.lua	/^function Map.obj_cls(_s, clsHa)$/;"	f
Map.obj_elm	map/lua/map_obj.lua	/^function Map.obj_elm(_s)$/;"	f
Map.obj_food	map/lua/map_obj.lua	/^function Map.obj_food(_s)$/;"	f
Map.obj_grp	map/lua/map_obj.lua	/^function Map.obj_grp(_s, p_cls)$/;"	f
Map.obj_grp__load	map/lua/map_obj.lua	/^function Map.obj_grp__load(_s, data, grp) -- -> func name rename$/;"	f
Map.obj_kagu	map/lua/map_obj.lua	/^function Map.obj_kagu(_s)$/;"	f
Map.obj_living	map/lua/map_obj.lua	/^function Map.obj_living(_s)$/;"	f
Map.on_msg	map/lua/map.lua	/^function Map.on_msg(_s, msg_id, prm, sender)$/;"	f
Map.pause__	map/lua/map.lua	/^function Map.pause__(_s, val)$/;"	f
Map.plychara__cre	map/lua/map_obj.lua	/^function Map.plychara__cre(_s, pos, dir)$/;"	f
Map.plychara_id	map/lua/map.lua	/^function Map.plychara_id(_s)$/;"	f
Map.plychara_pos	map/lua/map.lua	/^function Map.plychara_pos(_s)$/;"	f
Map.rng_pos	map/lua/map.lua	/^function Map.rng_pos(_s)$/;"	f
Map.rng_pos__init	map/lua/map.lua	/^function Map.rng_pos__init(_s)$/;"	f
Map.rng_tilepos	map/lua/map_tile.lua	/^function Map.rng_tilepos(_s, p_tilemap)$/;"	f
Map.save	map/lua/map.lua	/^function Map.save(_s)$/;"	f
Map.save_data	map/lua/map.lua	/^function Map.save_data(_s)$/;"	f
Map.save_del	map/lua/map.lua	/^function Map.save_del(_s)$/;"	f
Map.tile	map/lua/map_tile.lua	/^function Map.tile(_s, p_tilemap)$/;"	f
Map.tile_2_save_data	map/lua/map_tile.lua	/^function Map.tile_2_save_data(_s)$/;"	f
Map.tile__	map/lua/map_tile.lua	/^function Map.tile__(_s, data)$/;"	f
Map.tile__clr	map/lua/map_tile.lua	/^function Map.tile__clr(_s)$/;"	f
Map.tile__crct	map/lua/map.lua	/^function Map.tile__crct(p_tilepos, p_id, p_tilemap, layer)$/;"	f
Map.tile__new	map/lua/map_tile.lua	/^function Map.tile__new(_s)$/;"	f
Map.tile_bndl_arund_val	map/lua/map.lua	/^function Map.tile_bndl_arund_val(p_tilepos)$/;"	f
Map.tile_layer__	map/lua/map_tile.lua	/^function Map.tile_layer__(_s, p_tilemap, tiles) -- tiles[y][x]$/;"	f
Map.tilemap_url	map/lua/map.lua	/^function Map.tilemap_url(_s, p_tilemap)$/;"	f
Map.tilepos_arund	map/lua/map.lua	/^function Map.tilepos_arund(p_tilepos)$/;"	f
Map.upd	map/lua/map.lua	/^function Map.upd(_s, dt)$/;"	f
Mapobj.__	map/lua/mapobj.lua	/^function Mapobj.__(tilepos, cls, id)$/;"	f
Mapobj.del	map/lua/mapobj.lua	/^function Mapobj.del(tilepos, cls, id)$/;"	f
Mapobj.init	map/lua/mapobj.lua	/^function Mapobj.init(map_id)$/;"	f
Mapobj.map_rng_tilepos__	map/lua/mapobj.lua	/^function Mapobj.map_rng_tilepos__(rng_tilepos)$/;"	f
Mapobj.obj	map/lua/mapobj.lua	/^function Mapobj.obj(tilepos, clsHa)$/;"	f
Mapobj.obj_arund	map/lua/mapobj.lua	/^function Mapobj.obj_arund(p_tilepos, clsHa)$/;"	f
Meat.act_interval	obj/itm/food/meat/meat.lua	/^function Meat.act_interval(_s, dt)$/;"	f
Meat.cre	obj/itm/food/meat/meat.lua	/^function Meat.cre(pos, prm)$/;"	f
Meat.init	obj/itm/food/meat/meat.lua	/^function Meat.init(_s)$/;"	f
Meat.upd	obj/itm/food/meat/meat.lua	/^function Meat.upd(_s, dt)$/;"	f
Msg.s	etc/msg/msg.lua	/^function Msg.s(txt)$/;"	f
Mshrm.act_interval	obj/living/mshrm/mshrm.lua	/^function Mshrm.act_interval(_s, dt)$/;"	f
Mshrm.cre	obj/living/mshrm/mshrm.lua	/^function Mshrm.cre(pos)$/;"	f
Mshrm.final	obj/living/mshrm/mshrm.lua	/^function Mshrm.final(_s)$/;"	f
Mshrm.init	obj/living/mshrm/mshrm.lua	/^function Mshrm.init(_s)$/;"	f
Mshrm.on_msg	obj/living/mshrm/mshrm.lua	/^function Mshrm.on_msg(_s, msg_id, prm, sender)$/;"	f
Mshrm.upd	obj/living/mshrm/mshrm.lua	/^function Mshrm.upd(_s, dt)$/;"	f
Mstr.kagu__	sys/mstr/kagu.lua	/^function Mstr.kagu__()$/;"	f
O_anim.scl__1	obj/obj/o_anim.lua	/^function O_anim.scl__1(id, time)$/;"	f
Obj.fall._	obj/obj/obj.lua	/^function Obj.fall._(p_Cls)$/;"	f
Obj.fall.chara	obj/obj/obj.lua	/^function Obj.fall.chara()$/;"	f
Obj.fall.fire	obj/obj/obj.lua	/^function Obj.fall.fire()$/;"	f
Obj.fall.game_start	obj/obj/obj.lua	/^function Obj.fall.game_start()$/;"	f
Obj.fall.tree	obj/obj/obj.lua	/^function Obj.fall.tree()$/;"	f
Obj.fall.tst	obj/obj/obj.lua	/^function Obj.fall.tst()$/;"	f
Pc.act_interval	obj/itm/kagu/pc/pc.lua	/^function Pc.act_interval(_s, dt)$/;"	f
Pc.cre	obj/itm/kagu/pc/pc.lua	/^function Pc.cre(pos, prm)$/;"	f
Pc.final	obj/itm/kagu/pc/pc.lua	/^function Pc.final(_s)$/;"	f
Pc.init	obj/itm/kagu/pc/pc.lua	/^function Pc.init(_s)$/;"	f
Pc.on_msg	obj/itm/kagu/pc/pc.lua	/^function Pc.on_msg(_s, msg_id, prm, sender)$/;"	f
Pc.opn	obj/itm/kagu/pc/pc.lua	/^function Pc.opn(_s)$/;"	f
Pc.upd	obj/itm/kagu/pc/pc.lua	/^function Pc.upd(_s, dt)$/;"	f
Phantom.act_interval	obj/living/phantom/phantom/phantom.lua	/^function Phantom.act_interval(_s, dt)$/;"	f
Phantom.cre	obj/living/phantom/phantom/phantom.lua	/^function Phantom.cre(pos, prm)$/;"	f
Phantom.final	obj/living/phantom/phantom/phantom.lua	/^function Phantom.final(_s)$/;"	f
Phantom.init	obj/living/phantom/phantom/phantom.lua	/^function Phantom.init(_s)$/;"	f
Phantom.on_msg	obj/living/phantom/phantom/phantom.lua	/^function Phantom.on_msg(_s, msg_id, prm, sender)$/;"	f
Phantom.upd	obj/living/phantom/phantom/phantom.lua	/^function Phantom.upd(_s, dt)$/;"	f
Plant.act_interval	obj/living/plant/plant.lua	/^function Plant.act_interval(_s, dt)$/;"	f
Plant.cre	obj/living/plant/plant.lua	/^function Plant.cre(pos)$/;"	f
Plant.final	obj/living/plant/plant.lua	/^function Plant.final(_s)$/;"	f
Plant.init	obj/living/plant/plant.lua	/^function Plant.init(_s)$/;"	f
Plant.upd	obj/living/plant/plant.lua	/^function Plant.upd(_s, dt)$/;"	f
Ply_data._	sys/sq/game/ply_data/ply_data.lua	/^function Ply_data._()$/;"	f
Ply_data.__	sys/sq/game/ply_data/ply_data.lua	/^function Ply_data.__(data)$/;"	f
Ply_data.cfg._	sys/sq/game/ply_data/etc/cfg.lua	/^function Ply_data.cfg._()$/;"	f
Ply_data.cfg.__	sys/sq/game/ply_data/etc/cfg.lua	/^function Ply_data.cfg.__()$/;"	f
Ply_data.clr	sys/sq/game/ply_data/ply_data.lua	/^function Ply_data.clr()$/;"	f
Ply_data.gold	sys/sq/game/ply_data/etc/gold.lua	/^function Ply_data.gold()$/;"	f
Ply_data.gold__	sys/sq/game/ply_data/etc/gold.lua	/^function Ply_data.gold__(gold)$/;"	f
Ply_data.gold__add	sys/sq/game/ply_data/etc/gold.lua	/^function Ply_data.gold__add(gold)$/;"	f
Ply_data.gold__sub	sys/sq/game/ply_data/etc/gold.lua	/^function Ply_data.gold__sub(gold)$/;"	f
Ply_data.kzn._	sys/sq/game/ply_data/etc/kzn.lua	/^function Ply_data.kzn._()$/;"	f
Ply_data.kzn.__	sys/sq/game/ply_data/etc/kzn.lua	/^function Ply_data.kzn.__(data)$/;"	f
Ply_data.load	sys/sq/game/ply_data/ply_data.lua	/^function Ply_data.load(ply_slt_idx, file_idx)$/;"	f
Ply_data.new	sys/sq/game/ply_data/ply_data.lua	/^function Ply_data.new()$/;"	f
Ply_data.reizoko._	sys/sq/game/ply_data/etc/reizoko.lua	/^function Ply_data.reizoko._()$/;"	f
Ply_data.reizoko.__	sys/sq/game/ply_data/etc/reizoko.lua	/^function Ply_data.reizoko.__(data)$/;"	f
Ply_data.reizoko.__add	sys/sq/game/ply_data/etc/reizoko.lua	/^function Ply_data.reizoko.__add(prm)$/;"	f
Ply_data.reizoko.__new	sys/sq/game/ply_data/etc/reizoko.lua	/^function Ply_data.reizoko.__new()$/;"	f
Ply_data.save	sys/sq/game/ply_data/ply_data.lua	/^function Ply_data.save(ply_slt_idx)$/;"	f
Ply_data.zu._	sys/sq/game/ply_data/etc/zu.lua	/^function Ply_data.zu._()$/;"	f
Ply_data.zu.__	sys/sq/game/ply_data/etc/zu.lua	/^function Ply_data.zu.__(data)$/;"	f
Ply_data.zu.clr	sys/sq/game/ply_data/etc/zu.lua	/^function Ply_data.zu.clr()$/;"	f
Ply_data.zu.xxx._	sys/sq/game/ply_data/etc/zu.lua	/^function Ply_data.zu.xxx._(p_ar)$/;"	f
Ply_data.zu.xxx.__	sys/sq/game/ply_data/etc/zu.lua	/^function Ply_data.zu.xxx.__(data, cls, p_ar)$/;"	f
Plychara.clsn_add	obj/chara/plychara/plychara.lua	/^function Plychara.clsn_add(_s, target, id)$/;"	f
Plychara.clsn_clr	obj/chara/plychara/plychara.lua	/^function Plychara.clsn_clr(_s)$/;"	f
Plychara.clsn_holdable__	obj/chara/plychara/plychara.lua	/^function Plychara.clsn_holdable__(_s)$/;"	f
Plychara.crct_inside_map	obj/chara/plychara/plychara.lua	/^function Plychara.crct_inside_map(_s, vec)$/;"	f
Plychara.cre	obj/chara/plychara/plychara.lua	/^function Plychara.cre(pos, dir)$/;"	f
Plychara.dir__crct_hyprspc	obj/chara/plychara/plychara.lua	/^function Plychara.dir__crct_hyprspc(_s, dir)$/;"	f
Plychara.dstrct_mv_rng_pos	obj/chara/plychara/plychara.lua	/^function Plychara.dstrct_mv_rng_pos(_s)$/;"	f
Plychara.fairy_id	obj/chara/plychara/plychara.lua	/^function Plychara.fairy_id(_s)$/;"	f
Plychara.final	obj/chara/plychara/plychara.lua	/^function Plychara.final(_s)$/;"	f
Plychara.hold	obj/chara/plychara/plychara.lua	/^function Plychara.hold(_s)$/;"	f
Plychara.hold__o	obj/chara/plychara/plychara.lua	/^function Plychara.hold__o(_s, hold_id)$/;"	f
Plychara.hold__x	obj/chara/plychara/plychara.lua	/^function Plychara.hold__x(_s, p_id)$/;"	f
Plychara.hold_add	obj/chara/plychara/plychara.lua	/^function Plychara.hold_add(_s, id)$/;"	f
Plychara.hold_switch	obj/chara/plychara/plychara.lua	/^function Plychara.hold_switch(_s)$/;"	f
Plychara.hold_switch_o	obj/chara/plychara/plychara.lua	/^function Plychara.hold_switch_o(_s)$/;"	f
Plychara.hold_switch_x	obj/chara/plychara/plychara.lua	/^function Plychara.hold_switch_x(_s)$/;"	f
Plychara.hold_tile_side	obj/chara/plychara/plychara.lua	/^function Plychara.hold_tile_side(_s)$/;"	f
Plychara.in_clsn	obj/chara/plychara/plychara.lua	/^function Plychara.in_clsn(_s, keys)$/;"	f
Plychara.init	obj/chara/plychara/plychara.lua	/^function Plychara.init(_s)$/;"	f
Plychara.is_clsn	obj/chara/plychara/plychara.lua	/^function Plychara.is_clsn(_s, key)$/;"	f
Plychara.is_dstrct_mv	obj/chara/plychara/plychara.lua	/^function Plychara.is_dstrct_mv(_s, p_pos)$/;"	f
Plychara.is_hyprspc	obj/chara/plychara/plychara.lua	/^function Plychara.is_hyprspc(_s)$/;"	f
Plychara.itm_selected__	obj/chara/plychara/plychara.lua	/^function Plychara.itm_selected__(_s, itm)$/;"	f
Plychara.itm_use	obj/chara/plychara/plychara.lua	/^function Plychara.itm_use(_s, prm)$/;"	f
Plychara.on_msg	obj/chara/plychara/plychara.lua	/^function Plychara.on_msg(_s, msg_id, prm, sender)$/;"	f
Plychara.on_msg_act	obj/chara/plychara/plychara.lua	/^function Plychara.on_msg_act(_s, msg_id, prm, sender)$/;"	f
Plychara.on_msg_clsn	obj/chara/plychara/plychara.lua	/^function Plychara.on_msg_clsn(_s, msg_id, prm, sender)$/;"	f
Plychara.on_msg_mv	obj/chara/plychara/plychara.lua	/^function Plychara.on_msg_mv(_s, msg_id, prm, sender)$/;"	f
Plychara.ox_dstrct__mv	obj/chara/plychara/plychara.lua	/^function Plychara.ox_dstrct__mv(_s)$/;"	f
Plychara.pos_fw	obj/chara/plychara/plychara.lua	/^function Plychara.pos_fw(_s, mlt)$/;"	f
Plychara.to_cloud	obj/chara/plychara/plychara.lua	/^function Plychara.to_cloud(_s)$/;"	f
Plychara.to_door	obj/chara/plychara/plychara.lua	/^function Plychara.to_door(_s, door_id)$/;"	f
Plychara.upd	obj/chara/plychara/plychara.lua	/^function Plychara.upd(_s, dt)$/;"	f
Plychara.vec_on_clsn	obj/chara/plychara/plychara.lua	/^function Plychara.vec_on_clsn(_s, dt)$/;"	f
Reizoko.act_interval	obj/itm/kagu/reizoko/reizoko.lua	/^function Reizoko.act_interval(_s, dt)$/;"	f
Reizoko.cre	obj/itm/kagu/reizoko/reizoko.lua	/^function Reizoko.cre(pos)$/;"	f
Reizoko.final	obj/itm/kagu/reizoko/reizoko.lua	/^function Reizoko.final(_s)$/;"	f
Reizoko.init	obj/itm/kagu/reizoko/reizoko.lua	/^function Reizoko.init(_s)$/;"	f
Reizoko.into_reizoko	obj/itm/kagu/reizoko/reizoko.lua	/^function Reizoko.into_reizoko(_s, food_id)$/;"	f
Reizoko.on_msg	obj/itm/kagu/reizoko/reizoko.lua	/^function Reizoko.on_msg(_s, msg_id, prm, sender)$/;"	f
Reizoko.opn	obj/itm/kagu/reizoko/reizoko.lua	/^function Reizoko.opn(_s)$/;"	f
Reizoko.take_reizoko	obj/itm/kagu/reizoko/reizoko.lua	/^function Reizoko.take_reizoko(_s, food_idx)$/;"	f
Reizoko.upd	obj/itm/kagu/reizoko/reizoko.lua	/^function Reizoko.upd(_s, dt)$/;"	f
Se.pst_ply	etc/sound/se/se.lua	/^function Se.pst_ply(se)$/;"	f
Seed.act_interval	obj/living/seed/seed.lua	/^function Seed.act_interval(_s, dt)$/;"	f
Seed.cre	obj/living/seed/seed.lua	/^function Seed.cre(pos, prm)$/;"	f
Seed.final	obj/living/seed/seed.lua	/^function Seed.final(_s)$/;"	f
Seed.init	obj/living/seed/seed.lua	/^function Seed.init(_s)$/;"	f
Seed.on_msg	obj/living/seed/seed.lua	/^function Seed.on_msg(_s, msg_id, prm, sender)$/;"	f
Seed.upd	obj/living/seed/seed.lua	/^function Seed.upd(_s, dt)$/;"	f
Shelf.act_interval	obj/itm/kagu/shelf/shelf.lua	/^function Shelf.act_interval(_s, dt)$/;"	f
Shelf.cre	obj/itm/kagu/shelf/shelf.lua	/^function Shelf.cre(pos, prm)$/;"	f
Shelf.final	obj/itm/kagu/shelf/shelf.lua	/^function Shelf.final(_s)$/;"	f
Shelf.init	obj/itm/kagu/shelf/shelf.lua	/^function Shelf.init(_s)$/;"	f
Shelf.on_msg	obj/itm/kagu/shelf/shelf.lua	/^function Shelf.on_msg(_s, msg_id, prm, sender)$/;"	f
Shelf.opn	obj/itm/kagu/shelf/shelf.lua	/^function Shelf.opn(_s)$/;"	f
Shelf.upd	obj/itm/kagu/shelf/shelf.lua	/^function Shelf.upd(_s, dt)$/;"	f
Sky.act_interval__	map/bg/sky/sky.lua	/^function Sky.act_interval__(_s, dt)$/;"	f
Sky.changing__start	map/bg/sky/sky.lua	/^function Sky.changing__start(_s)$/;"	f
Sky.changing_obj	map/bg/sky/sky.lua	/^function Sky.changing_obj()$/;"	f
Sky.cre	map/bg/sky/sky.lua	/^function Sky.cre(sky_idx)$/;"	f
Sky.del	map/bg/sky/sky.lua	/^function Sky.del(_s)$/;"	f
Sky.dsp__	map/bg/sky/sky.lua	/^function Sky.dsp__(_s, val)$/;"	f
Sky.dsp__o	map/bg/sky/sky.lua	/^function Sky.dsp__o(_s)$/;"	f
Sky.dsp__x	map/bg/sky/sky.lua	/^function Sky.dsp__x(_s)$/;"	f
Sky.init	map/bg/sky/sky.lua	/^function Sky.init(_s)$/;"	f
Sky.on_msg	map/bg/sky/sky.lua	/^function Sky.on_msg(_s, msg_id, prm, sender)$/;"	f
Sky.plychara_id	map/bg/sky/sky.lua	/^function Sky.plychara_id(_s)$/;"	f
Sky.plychara_pos	map/bg/sky/sky.lua	/^function Sky.plychara_pos(_s)$/;"	f
Sky.sky_idx__rnd	map/bg/sky/sky.lua	/^function Sky.sky_idx__rnd()$/;"	f
Sky.sky_tile_base	map/bg/sky/sky.lua	/^function Sky.sky_tile_base(_s, sky_idx)$/;"	f
Sky.tile__by_pos	map/bg/sky/sky.lua	/^function Sky.tile__by_pos(_s, tile, p_pos)$/;"	f
Sky.tile__init	map/bg/sky/sky.lua	/^function Sky.tile__init(_s)$/;"	f
Sky.upd	map/bg/sky/sky.lua	/^function Sky.upd(_s, dt)$/;"	f
Sky.upd_dsp__	map/bg/sky/sky.lua	/^function Sky.upd_dsp__(_s) -- not use now$/;"	f
Sky.upd_tile	map/bg/sky/sky.lua	/^function Sky.upd_tile(_s, gradation_idx)$/;"	f
Sky.upd_tile__	map/bg/sky/sky.lua	/^function Sky.upd_tile__(_s, dt)$/;"	f
Sky.upd_tile__raindrop	map/bg/sky/sky.lua	/^function Sky.upd_tile__raindrop(_s, dt)$/;"	f
Sky.upd_tile_v__	map/bg/sky/sky.lua	/^function Sky.upd_tile_v__(_s, dt)$/;"	f
Sky.upd_tile_v__by_gradation	map/bg/sky/sky.lua	/^function Sky.upd_tile_v__by_gradation(_s, gradation_idx)$/;"	f
Sky.upd_tile_v__by_gradation_x	map/bg/sky/sky.lua	/^function Sky.upd_tile_v__by_gradation_x(_s, gradation_idx, x)$/;"	f
Sky.upd_tile_v_gradation	map/bg/sky/sky.lua	/^function Sky.upd_tile_v_gradation(_s)$/;"	f
Sky.upd_tile_v_gradation_x	map/bg/sky/sky.lua	/^function Sky.upd_tile_v_gradation_x(_s, gradation_idx)$/;"	f
Sp.Cls	obj/obj/sp.lua	/^function Sp.Cls(_s, p_prp)$/;"	f
Sp.__	obj/obj/sp.lua	/^function Sp.__(_s, key, val)$/;"	f
Sp.act_interval__	obj/obj/sp.lua	/^function Sp.act_interval__(_s, dt)$/;"	f
Sp.anim__	obj/obj/sp.lua	/^function Sp.anim__(_s, anim) -- anim(hash())$/;"	f
Sp.anm_cancel_pos	obj/obj/sp.lua	/^function Sp.anm_cancel_pos(_s)$/;"	f
Sp.cloud_id	obj/obj/sp.lua	/^function Sp.cloud_id(_s)$/;"	f
Sp.cloud_pos	obj/obj/sp.lua	/^function Sp.cloud_pos(_s)$/;"	f
Sp.cls	obj/obj/sp.lua	/^function Sp.cls(_s)$/;"	f
Sp.cls_is_mapobj	obj/obj/sp.lua	/^function Sp.cls_is_mapobj(_s)$/;"	f
Sp.crct_climb	obj/obj/sp.lua	/^function Sp.crct_climb(_s, vec)$/;"	f
Sp.crct_foot	obj/obj/sp.lua	/^function Sp.crct_foot(_s, vec)$/;"	f
Sp.crct_head	obj/obj/sp.lua	/^function Sp.crct_head(_s, vec)$/;"	f
Sp.crct_inside_map	obj/obj/sp.lua	/^function Sp.crct_inside_map(_s, vec)$/;"	f
Sp.crct_side	obj/obj/sp.lua	/^function Sp.crct_side(_s, vec)$/;"	f
Sp.crct_vec	obj/obj/sp.lua	/^function Sp.crct_vec(_s, vec)$/;"	f
Sp.crct_vec_block	obj/obj/sp.lua	/^function Sp.crct_vec_block(_s, vec)$/;"	f
Sp.cre	obj/obj/sp.lua	/^function Sp.cre(Cls, pos, prm, scl)$/;"	f
Sp.del	obj/obj/sp.lua	/^function Sp.del(_s)$/;"	f
Sp.dir_h__	obj/obj/sp.lua	/^function Sp.dir_h__(_s, dir_h)$/;"	f
Sp.dir_h__rnd	obj/obj/sp.lua	/^function Sp.dir_h__rnd(_s)$/;"	f
Sp.dir_v__	obj/obj/sp.lua	/^function Sp.dir_v__(_s, dir_v)$/;"	f
Sp.dir_v__rnd	obj/obj/sp.lua	/^function Sp.dir_v__rnd(_s)$/;"	f
Sp.dsp__o	obj/obj/sp.lua	/^function Sp.dsp__o(_s)$/;"	f
Sp.dsp__x	obj/obj/sp.lua	/^function Sp.dsp__x(_s)$/;"	f
Sp.final	obj/obj/sp.lua	/^function Sp.final(_s)$/;"	f
Sp.foot_dst_i	obj/obj/sp.lua	/^function Sp.foot_dst_i(_s)$/;"	f
Sp.foot_i_pos	obj/obj/sp.lua	/^function Sp.foot_i_pos(_s)$/;"	f
Sp.foot_i_tile	obj/obj/sp.lua	/^function Sp.foot_i_tile(_s)$/;"	f
Sp.foot_o_is_block	obj/obj/sp.lua	/^function Sp.foot_o_is_block(_s)$/;"	f
Sp.foot_o_pos	obj/obj/sp.lua	/^function Sp.foot_o_pos(_s)$/;"	f
Sp.foot_o_tile	obj/obj/sp.lua	/^function Sp.foot_o_tile(_s)$/;"	f
Sp.game_id	obj/obj/sp.lua	/^function Sp.game_id(_s)$/;"	f
Sp.head_o_is_block	obj/obj/sp.lua	/^function Sp.head_o_is_block(_s)$/;"	f
Sp.head_o_pos	obj/obj/sp.lua	/^function Sp.head_o_pos(_s)$/;"	f
Sp.head_o_tile	obj/obj/sp.lua	/^function Sp.head_o_tile(_s)$/;"	f
Sp.hflip__	obj/obj/sp.lua	/^function Sp.hflip__(_s, dir_h)$/;"	f
Sp.id	obj/obj/sp.lua	/^function Sp.id(_s)$/;"	f
Sp.init	obj/obj/sp.lua	/^function Sp.init(_s)$/;"	f
Sp.is_block	obj/obj/sp.lua	/^function Sp.is_block(_s, pos)$/;"	f
Sp.is_climb	obj/obj/sp.lua	/^function Sp.is_climb(_s, pos)$/;"	f
Sp.is_food	obj/obj/sp.lua	/^function Sp.is_food(_s)$/;"	f
Sp.is_loop__act_interval__	obj/obj/sp.lua	/^function Sp.is_loop__act_interval__(_s, dt)$/;"	f
Sp.is_on_obj_block	obj/obj/sp.lua	/^function Sp.is_on_obj_block(_s)$/;"	f
Sp.is_pause	obj/obj/sp.lua	/^function Sp.is_pause(_s)$/;"	f
Sp.is_soil	obj/obj/sp.lua	/^function Sp.is_soil(_s, pos)$/;"	f
Sp.log	obj/obj/sp.lua	/^function Sp.log(_s, ...)$/;"	f
Sp.log_cls	obj/obj/sp.lua	/^function Sp.log_cls(_s, cls, ...)$/;"	f
Sp.map_cnt_add	obj/obj/sp.lua	/^function Sp.map_cnt_add(_s)$/;"	f
Sp.map_cnt_del	obj/obj/sp.lua	/^function Sp.map_cnt_del(_s)$/;"	f
Sp.map_id	obj/obj/sp.lua	/^function Sp.map_id(_s)$/;"	f
Sp.map_inside_rng_pos	obj/obj/sp.lua	/^function Sp.map_inside_rng_pos(_s)$/;"	f
Sp.map_is_inside	obj/obj/sp.lua	/^function Sp.map_is_inside(_s, pos)$/;"	f
Sp.map_rng_pos	obj/obj/sp.lua	/^function Sp.map_rng_pos(_s)$/;"	f
Sp.mapobj__	obj/obj/sp.lua	/^function Sp.mapobj__(_s)$/;"	f
Sp.mapobj_del	obj/obj/sp.lua	/^function Sp.mapobj_del(_s)$/;"	f
Sp.name	obj/obj/sp.lua	/^function Sp.name(_s)$/;"	f
Sp.obj_arund	obj/obj/sp.lua	/^function Sp.obj_arund(_s, clsHa)$/;"	f
Sp.obj_d	obj/obj/sp.lua	/^function Sp.obj_d(_s, clsHa)$/;"	f
Sp.on_block	obj/obj/sp.lua	/^function Sp.on_block(_s) -- old$/;"	f
Sp.on_clsn	obj/obj/sp.lua	/^function Sp.on_clsn(_s)$/;"	f
Sp.on_msg	obj/obj/sp.lua	/^function Sp.on_msg(_s, msg_id, prm, sender)$/;"	f
Sp.parent__	obj/obj/sp.lua	/^function Sp.parent__(_s, parent_id, z, pos)$/;"	f
Sp.parent__map	obj/obj/sp.lua	/^function Sp.parent__map(_s)$/;"	f
Sp.per_del	obj/obj/sp.lua	/^function Sp.per_del(_s, per)$/;"	f
Sp.per_trnsf	obj/obj/sp.lua	/^function Sp.per_trnsf(_s, per, p_Cls, prm, scl)$/;"	f
Sp.ply_slt_idx	obj/obj/sp.lua	/^function Sp.ply_slt_idx(_s)$/;"	f
Sp.plychara_id	obj/obj/sp.lua	/^function Sp.plychara_id(_s)$/;"	f
Sp.plychara_pos	obj/obj/sp.lua	/^function Sp.plychara_pos(_s)$/;"	f
Sp.pos	obj/obj/sp.lua	/^function Sp.pos(_s)$/;"	f
Sp.pos__	obj/obj/sp.lua	/^function Sp.pos__(_s, pos)$/;"	f
Sp.pos__add	obj/obj/sp.lua	/^function Sp.pos__add(_s, vec)$/;"	f
Sp.say	obj/obj/sp.lua	/^function Sp.say(_s, str)$/;"	f
Sp.scl	obj/obj/sp.lua	/^function Sp.scl(_s)$/;"	f
Sp.scl__	obj/obj/sp.lua	/^function Sp.scl__(_s, vec)$/;"	f
Sp.scl__0	obj/obj/sp.lua	/^function Sp.scl__0(_s)$/;"	f
Sp.scl__1	obj/obj/sp.lua	/^function Sp.scl__1(_s)$/;"	f
Sp.scl_anim__1	obj/obj/sp.lua	/^function Sp.scl_anim__1(_s)$/;"	f
Sp.side_is_block	obj/obj/sp.lua	/^function Sp.side_is_block(_s, dir_h, vec)$/;"	f
Sp.side_pos	obj/obj/sp.lua	/^function Sp.side_pos(_s, dir_h, vec)$/;"	f
Sp.tile	obj/obj/sp.lua	/^function Sp.tile(_s, pos)$/;"	f
Sp.tile__	obj/obj/sp.lua	/^function Sp.tile__(_s, p_tile, p_pos)$/;"	f
Sp.tilepos	obj/obj/sp.lua	/^function Sp.tilepos(_s)$/;"	f
Sp.tilepos_arund	obj/obj/sp.lua	/^function Sp.tilepos_arund(_s)$/;"	f
Sp.tilepos_d	obj/obj/sp.lua	/^function Sp.tilepos_d(_s)$/;"	f
Sp.to_cloud	obj/obj/sp.lua	/^function Sp.to_cloud(_s)$/;"	f
Sp.trnsf	obj/obj/sp.lua	/^function Sp.trnsf(_s, p_Cls, prm, scl)$/;"	f
Sp.upd_pos_static	obj/obj/sp.lua	/^function Sp.upd_pos_static(_s, dt) -- static$/;"	f
Sp.url	obj/obj/sp.lua	/^function Sp.url(_s, cmp)$/;"	f
Sp.vec_grv	obj/obj/sp.lua	/^function Sp.vec_grv(_s, dt)$/;"	f
Sp.vec_grv_cnst	obj/obj/sp.lua	/^function Sp.vec_grv_cnst(_s, dt)$/;"	f
Sp.vec_tile	obj/obj/sp.lua	/^function Sp.vec_tile(_s, dt)$/;"	f
Sp.wpos	obj/obj/sp.lua	/^function Sp.wpos(_s)$/;"	f
Sp.z	obj/obj/sp.lua	/^function Sp.z(_s)$/;"	f
Sp.z__	obj/obj/sp.lua	/^function Sp.z__(_s, z)$/;"	f
Spwood.burn	obj/itm/wood/spwood.lua	/^function Spwood.burn(_s)$/;"	f
Spwood.final	obj/itm/wood/spwood.lua	/^function Spwood.final(_s)$/;"	f
Spwood.init	obj/itm/wood/spwood.lua	/^function Spwood.init(_s)$/;"	f
Spwood.on_msg	obj/itm/wood/spwood.lua	/^function Spwood.on_msg(_s, msg_id, prm, sender)$/;"	f
Sys.cmr_id	sys/sys/sys.lua	/^function Sys.cmr_id()$/;"	f
Sys.cmr_pos	sys/sys/sys.lua	/^function Sys.cmr_pos()$/;"	f
Sys.crnt_del	sys/sys/sys.lua	/^function Sys.crnt_del(_s)$/;"	f
Sys.game_continue	sys/sys/sys.lua	/^function Sys.game_continue(_s, ply_slt_idx, ply_data_file_idx)$/;"	f
Sys.game_id	sys/sys/sys.lua	/^function Sys.game_id()$/;"	f
Sys.game_new	sys/sys/sys.lua	/^function Sys.game_new(_s, ply_slt_idx)$/;"	f
Sys.init	sys/sys/sys.lua	/^function Sys.init(_s)$/;"	f
Sys.msg	etc/msg/msg.lua	/^function Sys.msg(txt)$/;"	f
Sys.msg_id	sys/sys/sys.lua	/^function Sys.msg_id()$/;"	f
Sys.msg_id__del	sys/sys/sys.lua	/^function Sys.msg_id__del(_s)$/;"	f
Sys.on_msg	sys/sys/sys.lua	/^function Sys.on_msg(_s, msg_id, prm, sender)$/;"	f
Sys.prp	sys/sys/sys.lua	/^function Sys.prp(key)$/;"	f
Sys.prp__	sys/sys/sys.lua	/^function Sys.prp__(key, val)$/;"	f
Sys.title	sys/sys/sys.lua	/^function Sys.title(_s)$/;"	f
Tile.is_block	etc/lua/tile.lua	/^function Tile.is_block(tile)$/;"	f
Tile.is_climb	etc/lua/tile.lua	/^function Tile.is_climb(tile)$/;"	f
Tile.is_elv	etc/lua/tile.lua	/^function Tile.is_elv(p_tile, dir)$/;"	f
Tile.is_wood	etc/lua/tile.lua	/^function Tile.is_wood(tile)$/;"	f
Tile.is_wood_burn	etc/lua/tile.lua	/^function Tile.is_wood_burn(tile)$/;"	f
Tile_bndl.arund_ar_2_arund_val	etc/lua/tile.lua	/^function Tile_bndl.arund_ar_2_arund_val(arund_ar)$/;"	f
Tile_bndl.arund_val_2_df_x5x5	etc/lua/tile.lua	/^function Tile_bndl.arund_val_2_df_x5x5(arund_val)$/;"	f
Tile_bndl.base_tile	etc/lua/tile.lua	/^function Tile_bndl.base_tile(p_tile)$/;"	f
Tile_bndl.crct_tile	etc/lua/tile.lua	/^function Tile_bndl.crct_tile(base_tile, arund_val)$/;"	f
Tile_bndl.crct_tile_by_df	etc/lua/tile.lua	/^function Tile_bndl.crct_tile_by_df(base_tile, df)$/;"	f
Tile_bndl.is_base_tile_bndl	etc/lua/tile.lua	/^function Tile_bndl.is_base_tile_bndl(p_tile, p_base_tile)$/;"	f
Tile_bndl.is_tile_bndl	etc/lua/tile.lua	/^function Tile_bndl.is_tile_bndl(p_tile)$/;"	f
Tile_bndl.is_tile_bndl_x5x5	etc/lua/tile.lua	/^function Tile_bndl.is_tile_bndl_x5x5(p_tile)$/;"	f
Title.cre	sys/sq/title/title.lua	/^function Title.cre()$/;"	f
Title.del	sys/sq/title/title.lua	/^function Title.del(_s)$/;"	f
Title.init	sys/sq/title/title.lua	/^function Title.init(_s)$/;"	f
Title.on_msg	sys/sq/title/title.lua	/^function Title.on_msg(_s, msg_id, prm, dender)$/;"	f
Title.upd	sys/sq/title/title.lua	/^function Title.upd(_s, dt)$/;"	f
Tree.act_interval	obj/living/tree/tree.lua	/^function Tree.act_interval(_s, dt)$/;"	f
Tree.bear	obj/living/tree/tree.lua	/^function Tree.bear(_s)$/;"	f
Tree.bear_x	obj/living/tree/tree.lua	/^function Tree.bear_x(_s, bear_id)$/;"	f
Tree.cre	obj/living/tree/tree.lua	/^function Tree.cre(pos, prm, scl)$/;"	f
Tree.final	obj/living/tree/tree.lua	/^function Tree.final(_s)$/;"	f
Tree.init	obj/living/tree/tree.lua	/^function Tree.init(_s)$/;"	f
Tree.on_msg	obj/living/tree/tree.lua	/^function Tree.on_msg(_s, msg_id, prm, sender)$/;"	f
Tree.trnsf_wood	obj/living/tree/tree.lua	/^function Tree.trnsf_wood(_s, num)$/;"	f
Tree.upd	obj/living/tree/tree.lua	/^function Tree.upd(_s, dt)$/;"	f
Veget.act_interval	obj/itm/food/veget/veget.lua	/^function Veget.act_interval(_s, dt)$/;"	f
Veget.cre	obj/itm/food/veget/veget.lua	/^function Veget.cre(pos, prm)$/;"	f
Veget.init	obj/itm/food/veget/veget.lua	/^function Veget.init(_s)$/;"	f
Veget.upd	obj/itm/food/veget/veget.lua	/^function Veget.upd(_s, dt)$/;"	f
Wa._	etc/ev/wa/wa.lua	/^function Wa._(sec)$/;"	f
Wa.cre	etc/ev/wa/wa.lua	/^function Wa.cre(sec)$/;"	f
Wa.init	etc/ev/wa/wa.lua	/^function Wa.init(_s)$/;"	f
Wa.on_msg	etc/ev/wa/wa.lua	/^function Wa.on_msg(_s, msg_id, prm, sender)$/;"	f
Wa.upd	etc/ev/wa/wa.lua	/^function Wa.upd(_s, dt)$/;"	f
Wa.wa	etc/ev/wa/wa.lua	/^function Wa.wa(_s, sec)$/;"	f
Wa.wa_fin	etc/ev/wa/wa.lua	/^function Wa.wa_fin(_s)$/;"	f
Wall.__	obj/itm/itm/wand/wall.lua	/^function Wall.__(tilepos, wall_idx)$/;"	f
Warp.cre	obj/elm/warp/warp.lua	/^function Warp.cre(pos, prm)$/;"	f
Warp.init	obj/elm/warp/warp.lua	/^function Warp.init(_s)$/;"	f
Warp.on_msg	obj/elm/warp/warp.lua	/^function Warp.on_msg(_s, msg_id, prm, sender)$/;"	f
Warp.on_msg_clsn	obj/elm/warp/warp.lua	/^function Warp.on_msg_clsn(_s, msg_id, prm, sender)$/;"	f
Wood.act_interval	obj/itm/wood/wood/wood.lua	/^function Wood.act_interval(_s, dt)$/;"	f
Wood.cre	obj/itm/wood/wood/wood.lua	/^function Wood.cre(pos)$/;"	f
Wood.final	obj/itm/wood/wood/wood.lua	/^function Wood.final(_s)$/;"	f
Wood.init	obj/itm/wood/wood/wood.lua	/^function Wood.init(_s)$/;"	f
Wood.upd	obj/itm/wood/wood/wood.lua	/^function Wood.upd(_s, dt)$/;"	f
_s._final_fnc	map/lua/map.lua	/^	_s._final_fnc = function ()$/;"	f
anim[1]	etc/lua/nd_anm.lua	/^	anim[1] = function ()$/;"	f
anim[1]	obj/chara/fuki/fuki/fuki.lua	/^	anim[1] = function ()$/;"	f
anim[1]	obj/itm/gold/gold.lua	/^	anim[1] = function ()$/;"	f
anim[2]	etc/lua/nd_anm.lua	/^	anim[2] = function ()$/;"	f
anim[2]	obj/chara/fuki/fuki/fuki.lua	/^	anim[2] = function ()$/;"	f
anim[2]	obj/itm/gold/gold.lua	/^	anim[2] = function ()$/;"	f
anim[3]	obj/itm/gold/gold.lua	/^	anim[3] = function ()$/;"	f
anm[1]	gui/gui/title/prt/ply_slt/ply_slt.lua	/^	anm[1] = function ()$/;"	f
anm[1]	gui/prt/bg/bg.lua	/^	anm[1] = function ()$/;"	f
anm[1]	gui/prt/confirm/confirm.lua	/^	anm[1] = function ()$/;"	f
anm[1]	gui/prt/ply_data/ply_data.lua	/^		anm[1] = function ()$/;"	f
anm[1]	gui/prt/prt/prt_itm.lua	/^	anm[1] = function ()$/;"	f
anm[2]	gui/gui/title/prt/ply_slt/ply_slt.lua	/^	anm[2] = function ()$/;"	f
anm[2]	gui/prt/bg/bg.lua	/^	anm[2] = function ()$/;"	f
anm[2]	gui/prt/confirm/confirm.lua	/^	anm[2] = function ()$/;"	f
anm[2]	gui/prt/ply_data/ply_data.lua	/^		anm[2] = function ()$/;"	f
anm[2]	gui/prt/prt/prt_itm.lua	/^	anm[2] = function ()$/;"	f
anm[3]	gui/prt/ply_data/ply_data.lua	/^		anm[3] = function ()$/;"	f
ar.add	etc/lua/ar.lua	/^function ar.add(p_ar, val)$/;"	f
ar.add_unq	etc/lua/ar.lua	/^function ar.add_unq(val, p_ar)$/;"	f
ar.clr	etc/lua/ar.lua	/^function ar.clr(p_ar)$/;"	f
ar.cp	etc/lua/ar.lua	/^function ar.cp(p_ar)$/;"	f
ar.del	etc/lua/ar.lua	/^function ar.del(p_ar)$/;"	f
ar.del1	etc/lua/ar.lua	/^function ar.del1(p_ar) -- old$/;"	f
ar.del_1	etc/lua/ar.lua	/^function ar.del_1(p_ar)$/;"	f
ar.del_by_idx	etc/lua/ar.lua	/^function ar.del_by_idx(p_ar, idx)$/;"	f
ar.del_by_val	etc/lua/ar.lua	/^function ar.del_by_val(val, p_ar)$/;"	f
ar.exclude	etc/lua/ar.lua	/^function ar.exclude(base, exclude)$/;"	f
ar.exclude_cp	etc/lua/ar.lua	/^function ar.exclude_cp(base, exclude)$/;"	f
ar.idx_2_ha	etc/lua/ar.lua	/^function ar.idx_2_ha(p_ar, pre)$/;"	f
ar.inHa	etc/lua/ar.lua	/^function ar.inHa(val, p_ar)$/;"	f
ar.in_	etc/lua/ar.lua	/^function ar.in_(val, p_ar)$/;"	f
ar.is_emp	etc/lua/ar.lua	/^function ar.is_emp(p_ar)$/;"	f
ar.join	etc/lua/ar.lua	/^function ar.join(...)$/;"	f
ar.key	etc/lua/ar.lua	/^function ar.key(p_ar)$/;"	f
ar.keyHa_srt	etc/lua/ar.lua	/^function ar.keyHa_srt(p_ar)$/;"	f
ar.key___	etc/lua/ar.lua	/^function ar.key___(p_ar)$/;"	f
ar.key_mrg	etc/lua/ar.lua	/^function ar.key_mrg(ar_org, ar_add)$/;"	f
ar.pop	etc/lua/ar.lua	/^function ar.pop(p_ar)$/;"	f
ar.psh	etc/lua/ar.lua	/^function ar.psh(p_ar, val)$/;"	f
ar.rnd	etc/lua/ar.lua	/^function ar.rnd(p_ar)$/;"	f
ar.srch_idx	etc/lua/ar.lua	/^function ar.srch_idx(val, p_ar)$/;"	f
ar.srt	etc/lua/ar.lua	/^function ar.srt(p_ar, cmp)$/;"	f
ar.val_str_2_ha	etc/lua/ar.lua	/^function ar.val_str_2_ha(p_ar)$/;"	f
clct.cre	etc/lua/clct.lua	/^function clct.cre(url, pos, prm)$/;"	f
cmp	etc/lua/ar.lua	/^	local cmp = function (val1, val2)$/;"	f
dice100.chk	etc/lua/dice100.lua	/^function dice100.chk(per)$/;"	f
dice100.throw	etc/lua/dice100.lua	/^function dice100.throw()$/;"	f
extend._	etc/lua/extend.lua	/^function extend._(obj, Cls)$/;"	f
extend.init	etc/lua/extend.lua	/^function extend.init(_s, Cls, ...)$/;"	f
fac.cre	etc/lua/fac.lua	/^function fac.cre(p_url, p_pos, p_rotation, p_prm)$/;"	f
file.d	sys/file/file.lua	/^function file.d(file_name_fl)$/;"	f
file.dstrct_2_str	sys/file/file.lua	/^function file.dstrct_2_str(dstrct)$/;"	f
file.file_name_fl	sys/file/file.lua	/^function file.file_name_fl(file_name)$/;"	f
file.map.del	sys/file/map.lua	/^function file.map.del(ply_slt_idx, dstrct, file_idx)$/;"	f
file.map.file_idx_ltst	sys/file/map.lua	/^function file.map.file_idx_ltst(ply_slt_idx, dstrct)$/;"	f
file.map.file_idx_nxt	sys/file/map.lua	/^function file.map.file_idx_nxt(ply_slt_idx, dstrct)$/;"	f
file.map.file_name	sys/file/map.lua	/^function file.map.file_name(ply_slt_idx, dstrct, file_idx)$/;"	f
file.map.file_name_ee	sys/file/map.lua	/^function file.map.file_name_ee(ply_slt_idx, dstrct, file_idx) -- ee : excld ext$/;"	f
file.map.file_name_fl	sys/file/map.lua	/^function file.map.file_name_fl(ply_slt_idx, dstrct, file_idx)$/;"	f
file.map.is_exst	sys/file/map.lua	/^function file.map.is_exst(ply_slt_idx, dstrct)$/;"	f
file.map.load	sys/file/map.lua	/^function file.map.load(ply_slt_idx, dstrct, file_idx)$/;"	f
file.map.ltst.del	sys/file/map.lua	/^function file.map.ltst.del(ply_slt_idx, dstrct, file_idx)$/;"	f
file.map.ltst.file_idx	sys/file/map.lua	/^function file.map.ltst.file_idx(ply_slt_idx, dstrct)$/;"	f
file.map.ltst.file_idx__	sys/file/map.lua	/^function file.map.ltst.file_idx__(ply_slt_idx, dstrct, file_idx_ltst)$/;"	f
file.map.ltst.file_name_fl	sys/file/map.lua	/^function file.map.ltst.file_name_fl(ply_slt_idx, dstrct)$/;"	f
file.map.ltst.load	sys/file/map.lua	/^function file.map.ltst.load(ply_slt_idx, dstrct)$/;"	f
file.map.ltst.save	sys/file/map.lua	/^function file.map.ltst.save(ply_slt_idx, dstrct, data)$/;"	f
file.map.save	sys/file/map.lua	/^function file.map.save(ply_slt_idx, dstrct, data)$/;"	f
file.ply_data.del	sys/file/ply_data.lua	/^function file.ply_data.del(ply_slt_idx, file_idx)$/;"	f
file.ply_data.file_idx_ltst	sys/file/ply_data.lua	/^function file.ply_data.file_idx_ltst(ply_slt_idx)$/;"	f
file.ply_data.file_idx_nxt	sys/file/ply_data.lua	/^function file.ply_data.file_idx_nxt(ply_slt_idx)$/;"	f
file.ply_data.file_name	sys/file/ply_data.lua	/^function file.ply_data.file_name(ply_slt_idx, file_idx)$/;"	f
file.ply_data.file_name_ee	sys/file/ply_data.lua	/^function file.ply_data.file_name_ee(ply_slt_idx, file_idx) -- ee : excld ext$/;"	f
file.ply_data.file_name_fl	sys/file/ply_data.lua	/^function file.ply_data.file_name_fl(ply_slt_idx, file_idx)$/;"	f
file.ply_data.load	sys/file/ply_data.lua	/^function file.ply_data.load(ply_slt_idx, file_idx)$/;"	f
file.ply_data.ltst.del	sys/file/ply_data.lua	/^function file.ply_data.ltst.del(ply_slt_idx, file_idx)$/;"	f
file.ply_data.ltst.file_idx	sys/file/ply_data.lua	/^function file.ply_data.ltst.file_idx(ply_slt_idx)$/;"	f
file.ply_data.ltst.file_idx__	sys/file/ply_data.lua	/^function file.ply_data.ltst.file_idx__(ply_slt_idx, file_idx_ltst)$/;"	f
file.ply_data.ltst.file_name_fl	sys/file/ply_data.lua	/^function file.ply_data.ltst.file_name_fl(ply_slt_idx)$/;"	f
file.ply_data.ltst.load	sys/file/ply_data.lua	/^function file.ply_data.ltst.load(ply_slt_idx)$/;"	f
file.ply_data.ltst.save	sys/file/ply_data.lua	/^function file.ply_data.ltst.save(ply_slt_idx, data)$/;"	f
file.ply_data.ltst.thmb	sys/file/ply_data.lua	/^function file.ply_data.ltst.thmb(ply_slt_idx)$/;"	f
file.ply_data.save	sys/file/ply_data.lua	/^function file.ply_data.save(ply_slt_idx, data)$/;"	f
file.ply_data.thmb.del	sys/file/ply_data.lua	/^function file.ply_data.thmb.del(ply_slt_idx, file_idx)$/;"	f
file.ply_data.thmb.file_name_fl	sys/file/ply_data.lua	/^function file.ply_data.thmb.file_name_fl(ply_slt_idx, file_idx)$/;"	f
file.ply_data.thmb.load	sys/file/ply_data.lua	/^function file.ply_data.thmb.load(ply_slt_idx, file_idx)$/;"	f
file.ply_data.thmb.save	sys/file/ply_data.lua	/^function file.ply_data.thmb.save(ply_slt_idx, file_idx, data)$/;"	f
file.ply_slt.file_name	sys/file/file.lua	/^function file.ply_slt.file_name(ply_slt_idx)$/;"	f
file.ply_slt.file_name_ee	sys/file/file.lua	/^function file.ply_slt.file_name_ee(ply_slt_idx) -- ee : excld ext$/;"	f
file.ply_slt.file_name_fl	sys/file/file.lua	/^function file.ply_slt.file_name_fl(ply_slt_idx)$/;"	f
file.r	sys/file/file.lua	/^function file.r(file_name_fl)$/;"	f
file.ts	sys/file/file.lua	/^function file.ts()$/;"	f
file.ts__	sys/file/file.lua	/^function file.ts__()$/;"	f
file.ts_str	sys/file/file.lua	/^function file.ts_str()$/;"	f
file.w	sys/file/file.lua	/^function file.w(file_name_fl, data)$/;"	f
fnc	etc/sound/bgm/bgm.lua	/^	local fnc = function (slf, hndl, elpsd)$/;"	f
fnc	gui/gui/msg/prt/msg/msg.lua	/^	local fnc = function (slf, hndl, elpsd)$/;"	f
fnc	gui/prt/bg/bg.lua	/^	local fnc = function (slf, hndl, elpsd)$/;"	f
g.Bag.actv_prt	gui/gui/bag/_/bag_gui.lua	/^function g.Bag.actv_prt(_s)$/;"	f
g.Bag.base_clz	gui/gui/bag/_/bag_gui.lua	/^function g.Bag.base_clz(_s)$/;"	f
g.Bag.base_opn	gui/gui/bag/_/bag_gui.lua	/^function g.Bag.base_opn(_s)$/;"	f
g.Bag.clz	gui/gui/bag/_/bag_gui.lua	/^function g.Bag.clz(_s)$/;"	f
g.Bag.dsp__	gui/gui/bag/_/bag_gui.lua	/^function g.Bag.dsp__(_s, val)$/;"	f
g.Bag.focus_ch	gui/gui/bag/_/bag_gui.lua	/^function g.Bag.focus_ch(_s)$/;"	f
g.Bag.init	gui/gui/bag/_/bag_gui.lua	/^function g.Bag.init(_s)$/;"	f
g.Bag.l_clz	gui/gui/bag/_/bag_gui.lua	/^function g.Bag.l_clz(_s)$/;"	f
g.Bag.l_opn	gui/gui/bag/_/bag_gui.lua	/^function g.Bag.l_opn(_s)$/;"	f
g.Bag.opn	gui/gui/bag/_/bag_gui.lua	/^function g.Bag.opn(_s, prm)$/;"	f
g.Bag.r_clz	gui/gui/bag/_/bag_gui.lua	/^function g.Bag.r_clz(_s)$/;"	f
g.Bag.r_opn	gui/gui/bag/_/bag_gui.lua	/^function g.Bag.r_opn(_s)$/;"	f
g.Bag.r_view_prt	gui/gui/bag/_/bag_gui.lua	/^function g.Bag.r_view_prt(_s)$/;"	f
g.Bag.r_view_prt__	gui/gui/bag/_/bag_gui.lua	/^function g.Bag.r_view_prt__(_s, prt_lb)$/;"	f
g.Bag.r_view_prt_clz	gui/gui/bag/_/bag_gui.lua	/^function g.Bag.r_view_prt_clz(_s)$/;"	f
g.Bag.r_view_prt_lb	gui/gui/bag/_/bag_gui.lua	/^function g.Bag.r_view_prt_lb(_s)$/;"	f
g.Bag.r_view_prt_lb__	gui/gui/bag/_/bag_gui.lua	/^function g.Bag.r_view_prt_lb__(_s, prt_lb)$/;"	f
g.Bag.r_view_prt_opn	gui/gui/bag/_/bag_gui.lua	/^function g.Bag.r_view_prt_opn(_s)$/;"	f
g.Dia.chara__	gui/gui/dia/_/dia_gui.lua	/^function g.Dia.chara__(_s, chara)$/;"	f
g.Dia.init	gui/gui/dia/_/dia_gui.lua	/^function g.Dia.init(_s)$/;"	f
g.Dia.on_msg	gui/gui/dia/_/dia_gui.lua	/^function g.Dia.on_msg(_s, msg_id, prm, sender)$/;"	f
g.Door.init	gui/gui/door/_/door_gui.lua	/^function g.Door.init(_s)$/;"	f
g.Flpy.init	gui/gui/flpy/_/flpy_gui.lua	/^function g.Flpy.init(_s)$/;"	f
g.Gui.actv_prt	gui/gui/gui/gui.lua	/^function g.Gui.actv_prt(_s)$/;"	f
g.Gui.actv_prt__pop	gui/gui/gui/gui.lua	/^function g.Gui.actv_prt__pop(_s, prt_lb)$/;"	f
g.Gui.actv_prt__psh	gui/gui/gui/gui.lua	/^function g.Gui.actv_prt__psh(_s, prt_lb)$/;"	f
g.Gui.actv_prt_actv__o	gui/gui/gui/gui.lua	/^function g.Gui.actv_prt_actv__o(_s)$/;"	f
g.Gui.actv_prt_actv__x	gui/gui/gui/gui.lua	/^function g.Gui.actv_prt_actv__x(_s)$/;"	f
g.Gui.actv_prt_clz	gui/gui/gui/gui.lua	/^function g.Gui.actv_prt_clz(_s, prm)$/;"	f
g.Gui.actv_prt_key_2_act	gui/gui/gui/gui.lua	/^function g.Gui.actv_prt_key_2_act(_s, prm)$/;"	f
g.Gui.actv_prt_lb	gui/gui/gui/gui.lua	/^function g.Gui.actv_prt_lb(_s)$/;"	f
g.Gui.actv_prt_opn	gui/gui/gui/gui.lua	/^function g.Gui.actv_prt_opn(_s, prm)$/;"	f
g.Gui.back	gui/gui/gui/gui.lua	/^function g.Gui.back(_s)$/;"	f
g.Gui.clz	gui/gui/gui/gui.lua	/^function g.Gui.clz(_s)$/;"	f
g.Gui.confirm	gui/gui/gui/gui.lua	/^function g.Gui.confirm(_s)$/;"	f
g.Gui.confirm_opn	gui/gui/gui/gui.lua	/^function g.Gui.confirm_opn(_s, called_by_prt)$/;"	f
g.Gui.del	gui/gui/gui/gui.lua	/^function g.Gui.del(_s)$/;"	f
g.Gui.final	gui/gui/gui/gui.lua	/^function g.Gui.final(_s)$/;"	f
g.Gui.focus__	gui/gui/gui/gui.lua	/^function g.Gui.focus__(_s, val)$/;"	f
g.Gui.init	gui/gui/gui/gui.lua	/^function g.Gui.init(_s)$/;"	f
g.Gui.on_msg	gui/gui/gui/gui.lua	/^function g.Gui.on_msg(_s, msg_id, prm, sender)$/;"	f
g.Gui.opn	gui/gui/gui/gui.lua	/^function g.Gui.opn(_s, prt_lb, prm)$/;"	f
g.Gui.prp__	gui/gui/gui/gui.lua	/^function g.Gui.prp__(_s, prm)$/;"	f
g.Msg.del	gui/gui/msg/_/msg_gui.lua	/^function g.Msg.del(_s)$/;"	f
g.Msg.init	gui/gui/msg/_/msg_gui.lua	/^function g.Msg.init(_s)$/;"	f
g.Msg.itm__add	gui/gui/msg/_/msg_gui.lua	/^function g.Msg.itm__add(_s, itm)$/;"	f
g.Msg.on_msg	gui/gui/msg/_/msg_gui.lua	/^function g.Msg.on_msg(_s, msg_id, prm, sender)$/;"	f
g.Pc.init	gui/gui/pc/_/pc_gui.lua	/^function g.Pc.init(_s)$/;"	f
g.Reizoko.init	gui/gui/reizoko/_/reizoko_gui.lua	/^function g.Reizoko.init(_s)$/;"	f
g.Shelf.init	gui/gui/shelf/_/shelf_gui.lua	/^function g.Shelf.init(_s)$/;"	f
g.Title.init	gui/gui/title/_/title_gui.lua	/^function g.Title.init(_s)$/;"	f
ha._	etc/lua/ha.lua	/^function ha._(val)$/;"	f
ha.add	etc/lua/ha.lua	/^function ha.add(val)$/;"	f
ha.add_by_Cls	etc/lua/ha.lua	/^function ha.add_by_Cls(Cls)$/;"	f
ha.add_by_ar	etc/lua/ha.lua	/^function ha.add_by_ar(p_ar)$/;"	f
ha.add_by_key_num	etc/lua/ha.lua	/^function ha.add_by_key_num(key, num)$/;"	f
ha.de	etc/lua/ha.lua	/^function ha.de(keyHa)$/;"	f
ha.emp	etc/lua/ha.lua	/^function ha.emp()$/;"	f
ha.eq	etc/lua/ha.lua	/^function ha.eq(val, key)$/;"	f
ha.idx2ha	etc/lua/ha.lua	/^function ha.idx2ha(idx_ar)$/;"	f
ha.is_emp	etc/lua/ha.lua	/^function ha.is_emp(val)$/;"	f
id.cls	etc/lua/id.lua	/^function id.cls(p_id)$/;"	f
id.del	etc/lua/id.lua	/^function id.del(p_id, val)$/;"	f
id.name	etc/lua/id.lua	/^function id.name(p_id)$/;"	f
id.pos	etc/lua/id.lua	/^function id.pos(id)$/;"	f
id.pos__	etc/lua/id.lua	/^function id.pos__(p_id, pos)$/;"	f
id.prp	etc/lua/id.lua	/^function id.prp(p_id, key)$/;"	f
id.prp__	etc/lua/id.lua	/^function id.prp__(p_id, key, val)$/;"	f
id.prp_de	etc/lua/id.lua	/^function id.prp_de(p_id, key)$/;"	f
id.pst	etc/lua/id.lua	/^function id.pst(id, msg_id, prm)$/;"	f
id.wpos	etc/lua/id.lua	/^function id.wpos(id)$/;"	f
id.z__	etc/lua/id.lua	/^function id.z__(p_id, z)$/;"	f
int._2_str	etc/lua/int.lua	/^function int._2_str(p_int)$/;"	f
int.dlm	etc/lua/int.lua	/^function int.dlm(idx, dlm_idx)$/;"	f
int.is_rng	etc/lua/int.lua	/^function int.is_rng(idx, p_ar) -- ar: {min, max}$/;"	f
int.pad	etc/lua/int.lua	/^function int.pad(i, digit, str)$/;"	f
int.sub_loop	etc/lua/int.lua	/^function int.sub_loop(num, d, max)$/;"	f
log._	etc/lua/log.lua	/^function log._(...)$/;"	f
log.asrt	etc/lua/log.lua	/^function log.asrt(txt, data)$/;"	f
log.f	etc/lua/log.lua	/^function log.f(txt, val, dgt)$/;"	f
log.fltr_cls	etc/lua/log.lua	/^function log.fltr_cls(cls, ...)$/;"	f
log.pp	etc/lua/log.lua	/^function log.pp(txt, data)$/;"	f
log.save_data_tile	etc/lua/log.lua	/^function log.save_data_tile(tile, y_fr, y_to, x_fr, x_to) -- tile["y_idx_str"]["x_idx_str"]$/;"	f
log.script	etc/lua/log.lua	/^function log.script(file)$/;"	f
map.inside_rng_pos	etc/lua/map.lua	/^function map.inside_rng_pos(p_id, p_tilemap, tilesize)$/;"	f
map.is_inside	etc/lua/map.lua	/^function map.is_inside(p_pos, p_id, p_tilemap, tilesize)$/;"	f
map.is_inside_cmpr	etc/lua/map.lua	/^function map.is_inside_cmpr(p_pos, inside_rng_pos)$/;"	f
map.is_inside_tilepos	etc/lua/map.lua	/^function map.is_inside_tilepos(tilepos, p_id, p_tilemap)$/;"	f
map.is_inside_tilepos_cmpr	etc/lua/map.lua	/^function map.is_inside_tilepos_cmpr(tilepos, rng_tilepos)$/;"	f
map.pos_2_tilepos	etc/lua/map.lua	/^function map.pos_2_tilepos(pos)$/;"	f
map.pos_by_pos	etc/lua/map.lua	/^function map.pos_by_pos(pos)$/;"	f
map.pos_by_tilepos	etc/lua/map.lua	/^function map.pos_by_tilepos(tilepos)$/;"	f
map.rng_pos	etc/lua/map.lua	/^function map.rng_pos(p_id, p_tilemap, tilesize)$/;"	f
map.rng_tilepos	etc/lua/map.lua	/^function map.rng_tilepos(p_id, p_tilemap)$/;"	f
map.rng_tilepos_xy	etc/lua/map.lua	/^function map.rng_tilepos_xy(p_id, p_tilemap)$/;"	f
map.tile	etc/lua/map.lua	/^function map.tile(pos, p_id, p_tilemap, layer)$/;"	f
map.tile__	etc/lua/map.lua	/^function map.tile__(pos, tile, p_id, p_tilemap, layer)$/;"	f
map.tile__by_tilepos	etc/lua/map.lua	/^function map.tile__by_tilepos(p_tilepos, p_tile, p_id, p_tilemap, layer)$/;"	f
map.tile_bound	etc/lua/map.lua	/^function map.tile_bound(p_id, p_tilemap)$/;"	f
map.tile_by_tilepos	etc/lua/map.lua	/^function map.tile_by_tilepos(tilepos, p_id, p_tilemap, layer)$/;"	f
n.pos	etc/lua/pos.lua	/^function n.pos(x, y, z)$/;"	f
n.vec	etc/lua/vec.lua	/^function n.vec(x, y, z)   -- alias <- use now$/;"	f
nd._	etc/lua/nd.lua	/^function nd._(name)$/;"	f
nd.anim	etc/lua/nd.lua	/^function nd.anim(p_nd)$/;"	f
nd.anm.color__	etc/lua/nd_anm.lua	/^function nd.anm.color__(p_nd, p_color, time, fin)$/;"	f
nd.anm.dkdk	etc/lua/nd_anm.lua	/^function nd.anm.dkdk(p_nd, time, scl_val)$/;"	f
nd.anm.dsp__	etc/lua/nd_anm.lua	/^function nd.anm.dsp__(p_nd, val, time, fin)$/;"	f
nd.anm.dsp__o	etc/lua/nd_anm.lua	/^function nd.anm.dsp__o(p_nd, fin, time)$/;"	f
nd.anm.dsp__x	etc/lua/nd_anm.lua	/^function nd.anm.dsp__x(p_nd, fin, time)$/;"	f
nd.anm.fade__	etc/lua/nd_anm.lua	/^function nd.anm.fade__(p_nd, w, time, fin) -- alias nd.anm.w__()$/;"	f
nd.anm.fade__i	etc/lua/nd_anm.lua	/^function nd.anm.fade__i(p_nd, time, fin)$/;"	f
nd.anm.fade__o	etc/lua/nd_anm.lua	/^function nd.anm.fade__o(p_nd, time, fin)$/;"	f
nd.anm.iyaiya	etc/lua/nd_anm.lua	/^function nd.anm.iyaiya(p_nd, time)$/;"	f
nd.anm.mv	etc/lua/nd_anm.lua	/^function nd.anm.mv(p_nd, pos, fin, time)$/;"	f
nd.anm.poyon	etc/lua/nd_anm.lua	/^function nd.anm.poyon(p_nd, fin, time, scl_val)$/;"	f
nd.anm.pyon_d_l	etc/lua/nd_anm.lua	/^function nd.anm.pyon_d_l(p_nd, time)$/;"	f
nd.anm.scl0	etc/lua/nd_anm.lua	/^function nd.anm.scl0(p_nd, fin, time)$/;"	f
nd.anm.w__	etc/lua/nd_anm.lua	/^function nd.anm.w__(p_nd, w, time, fin)$/;"	f
nd.anm__	etc/lua/nd.lua	/^function nd.anm__(p_nd, p_anm)$/;"	f
nd.ar.del	etc/lua/nd_ar.lua	/^function nd.ar.del(p_nd_ar)$/;"	f
nd.ar.enbl__	etc/lua/nd_ar.lua	/^function nd.ar.enbl__(p_nd_ar, val)$/;"	f
nd.clone	etc/lua/nd.lua	/^function nd.clone(p_nd)$/;"	f
nd.color	etc/lua/nd.lua	/^function nd.color(p_nd)$/;"	f
nd.color__	etc/lua/nd.lua	/^function nd.color__(p_nd, color)$/;"	f
nd.del	etc/lua/nd.lua	/^function nd.del(p_nd)$/;"	f
nd.dsp__	etc/lua/nd.lua	/^function nd.dsp__(p_nd, val)$/;"	f
nd.dsp__o	etc/lua/nd.lua	/^function nd.dsp__o(p_nd)$/;"	f
nd.dsp__x	etc/lua/nd.lua	/^function nd.dsp__x(p_nd)$/;"	f
nd.enbl__	etc/lua/nd.lua	/^function nd.enbl__(p_nd, val)$/;"	f
nd.enbl__o	etc/lua/nd.lua	/^function nd.enbl__o(p_nd)$/;"	f
nd.enbl__x	etc/lua/nd.lua	/^function nd.enbl__x(p_nd)$/;"	f
nd.order__by_abv	etc/lua/nd.lua	/^function nd.order__by_abv(p_nd, p_nd_abv)$/;"	f
nd.order__by_blw	etc/lua/nd.lua	/^function nd.order__by_blw(p_nd, p_nd_blw)$/;"	f
nd.parent__	etc/lua/nd.lua	/^function nd.parent__(p_nd, p_parent_nd)$/;"	f
nd.pos	etc/lua/nd.lua	/^function nd.pos(p_nd)$/;"	f
nd.pos__	etc/lua/nd.lua	/^function nd.pos__(p_nd, vec)$/;"	f
nd.txt	etc/lua/nd.lua	/^function nd.txt(p_nd)$/;"	f
nd.txt__	etc/lua/nd.lua	/^function nd.txt__(p_nd, txt)$/;"	f
nd.txtr	etc/lua/nd.lua	/^function nd.txtr(p_nd)$/;"	f
nd.txtr__	etc/lua/nd.lua	/^function nd.txtr__(p_nd, txtr)$/;"	f
nd.w	etc/lua/nd.lua	/^function nd.w(p_nd)$/;"	f
nd.w__	etc/lua/nd.lua	/^function nd.w__(p_nd, w)$/;"	f
num._2_int_d	etc/lua/num.lua	/^function num._2_int_d(num)$/;"	f
num._2_int_u	etc/lua/num.lua	/^function num._2_int_u(num)$/;"	f
num._2_sign	etc/lua/num.lua	/^function num._2_sign(p_num)$/;"	f
num.is_rng	etc/lua/num.lua	/^function num.is_rng(p_num, p_ar) -- {min, max}$/;"	f
p.Bag_block.cre	gui/gui/bag/prt/block/bag_block.lua	/^function p.Bag_block.cre(parent_gui)$/;"	f
p.Bag_block.decide	gui/gui/bag/prt/block/bag_block.lua	/^function p.Bag_block.decide(_s)$/;"	f
p.Bag_block.init	gui/gui/bag/prt/block/bag_block.lua	/^function p.Bag_block.init(_s, parent_gui)$/;"	f
p.Bag_inf.cre	gui/gui/bag/prt/inf/bag_inf.lua	/^function p.Bag_inf.cre(parent_gui)$/;"	f
p.Bag_inf.init	gui/gui/bag/prt/inf/bag_inf.lua	/^function p.Bag_inf.init(_s, parent_gui)$/;"	f
p.Bag_inf.opn	gui/gui/bag/prt/inf/bag_inf.lua	/^function p.Bag_inf.opn(_s)$/;"	f
p.Bag_itm.bag_r_view__	gui/gui/bag/prt/itm/bag_itm.lua	/^function p.Bag_itm.bag_r_view__(_s)$/;"	f
p.Bag_itm.cre	gui/gui/bag/prt/itm/bag_itm.lua	/^function p.Bag_itm.cre(parent_gui)$/;"	f
p.Bag_itm.cursor_mv_exe	gui/gui/bag/prt/itm/bag_itm.lua	/^function p.Bag_itm.cursor_mv_exe(_s)$/;"	f
p.Bag_itm.decide	gui/gui/bag/prt/itm/bag_itm.lua	/^function p.Bag_itm.decide(_s)$/;"	f
p.Bag_itm.init	gui/gui/bag/prt/itm/bag_itm.lua	/^function p.Bag_itm.init(_s, parent_gui)$/;"	f
p.Bag_itm.key_2_act_itm	gui/gui/bag/prt/itm/bag_itm.lua	/^function p.Bag_itm.key_2_act_itm(_s, prm)$/;"	f
p.Bag_itm.plychara_itm_selected__	gui/gui/bag/prt/itm/bag_itm.lua	/^function p.Bag_itm.plychara_itm_selected__(_s)$/;"	f
p.Bag_prt.init	gui/gui/bag/prt/bag_prt/bag_prt.lua	/^function p.Bag_prt.init(_s)$/;"	f
p.Bag_prt.opn	gui/gui/bag/prt/bag_prt/bag_prt.lua	/^function p.Bag_prt.opn(_s)$/;"	f
p.Bag_prt_itm.actv__	gui/gui/bag/prt/bag_prt/bag_prt_itm.lua	/^function p.Bag_prt_itm.actv__(_s, val)$/;"	f
p.Bag_prt_itm.arw_act_othr	gui/gui/bag/prt/bag_prt/bag_prt_itm.lua	/^function p.Bag_prt_itm.arw_act_othr(_s, inc_dir, keyact)$/;"	f
p.Bag_prt_itm.clz	gui/gui/bag/prt/bag_prt/bag_prt_itm.lua	/^function p.Bag_prt_itm.clz(_s)$/;"	f
p.Bag_prt_itm.init	gui/gui/bag/prt/bag_prt/bag_prt_itm.lua	/^function p.Bag_prt_itm.init(_s)$/;"	f
p.Bag_prt_itm.key_2_act_itm	gui/gui/bag/prt/bag_prt/bag_prt_itm.lua	/^function p.Bag_prt_itm.key_2_act_itm(_s, prm)$/;"	f
p.Bag_prt_itm.opn	gui/gui/bag/prt/bag_prt/bag_prt_itm.lua	/^function p.Bag_prt_itm.opn(_s)$/;"	f
p.Bag_prt_itm.parent_gui_clz	gui/gui/bag/prt/bag_prt/bag_prt_itm.lua	/^function p.Bag_prt_itm.parent_gui_clz(_s)$/;"	f
p.Bag_wall.cre	gui/gui/bag/prt/wall/bag_wall.lua	/^function p.Bag_wall.cre(parent_gui)$/;"	f
p.Bag_wall.decide	gui/gui/bag/prt/wall/bag_wall.lua	/^function p.Bag_wall.decide(_s)$/;"	f
p.Bag_wall.init	gui/gui/bag/prt/wall/bag_wall.lua	/^function p.Bag_wall.init(_s, parent_gui)$/;"	f
p.Bg.bg__	gui/prt/bg/bg.lua	/^function p.Bg.bg__(_s, p_anm)$/;"	f
p.Bg.bg__rnd	gui/prt/bg/bg.lua	/^function p.Bg.bg__rnd(_s)$/;"	f
p.Bg.cre	gui/prt/bg/bg.lua	/^function p.Bg.cre(parent_gui)$/;"	f
p.Bg.init	gui/prt/bg/bg.lua	/^function p.Bg.init(_s, parent_gui)$/;"	f
p.Cfg.cre	gui/gui/pc/prt/cfg/cfg.lua	/^function p.Cfg.cre(parent_gui)$/;"	f
p.Cfg.decide	gui/gui/pc/prt/cfg/cfg.lua	/^function p.Cfg.decide(_s)$/;"	f
p.Cfg.init	gui/gui/pc/prt/cfg/cfg.lua	/^function p.Cfg.init(_s, parent_gui)$/;"	f
p.Cfg.opn	gui/gui/pc/prt/cfg/cfg.lua	/^function p.Cfg.opn(_s)$/;"	f
p.Confirm.cre	gui/prt/confirm/confirm.lua	/^function p.Confirm.cre(parent_gui)$/;"	f
p.Confirm.decide	gui/prt/confirm/confirm.lua	/^function p.Confirm.decide(_s)$/;"	f
p.Confirm.exe	gui/prt/confirm/confirm.lua	/^function p.Confirm.exe(_s)$/;"	f
p.Confirm.init	gui/prt/confirm/confirm.lua	/^function p.Confirm.init(_s, parent_gui)$/;"	f
p.Confirm.opn	gui/prt/confirm/confirm.lua	/^function p.Confirm.opn(_s, prm)$/;"	f
p.Dia.chara__	gui/gui/dia/prt/dia/dia.lua	/^function p.Dia.chara__(_s, chara)$/;"	f
p.Dia.clz	gui/gui/dia/prt/dia/dia.lua	/^function p.Dia.clz(_s, se_off)$/;"	f
p.Dia.cre	gui/gui/dia/prt/dia/dia.lua	/^function p.Dia.cre(parent_gui)$/;"	f
p.Dia.decide	gui/gui/dia/prt/dia/dia.lua	/^function p.Dia.decide(_s)$/;"	f
p.Dia.init	gui/gui/dia/prt/dia/dia.lua	/^function p.Dia.init(_s, parent_gui)$/;"	f
p.Dia.key_2_act_itm	gui/gui/dia/prt/dia/dia.lua	/^function p.Dia.key_2_act_itm(_s, prm)$/;"	f
p.Dia.nxt	gui/gui/dia/prt/dia/dia.lua	/^function p.Dia.nxt(_s)$/;"	f
p.Dia.opn	gui/gui/dia/prt/dia/dia.lua	/^function p.Dia.opn(_s, prm)$/;"	f
p.Dia.txt__	gui/gui/dia/prt/dia/dia.lua	/^function p.Dia.txt__(_s, txt)$/;"	f
p.Door.cre	gui/gui/door/prt/door/door.lua	/^function p.Door.cre(parent_gui)$/;"	f
p.Door.decide	gui/gui/door/prt/door/door.lua	/^function p.Door.decide(_s)$/;"	f
p.Door.init	gui/gui/door/prt/door/door.lua	/^function p.Door.init(_s, parent_gui)$/;"	f
p.Flpy.back_to_title	gui/gui/flpy/prt/flpy/flpy.lua	/^function p.Flpy.back_to_title(_s)$/;"	f
p.Flpy.cre	gui/gui/flpy/prt/flpy/flpy.lua	/^function p.Flpy.cre(parent_gui)$/;"	f
p.Flpy.decide	gui/gui/flpy/prt/flpy/flpy.lua	/^function p.Flpy.decide(_s)$/;"	f
p.Flpy.init	gui/gui/flpy/prt/flpy/flpy.lua	/^function p.Flpy.init(_s, parent_gui)$/;"	f
p.Flpy.opn	gui/gui/flpy/prt/flpy/flpy.lua	/^function p.Flpy.opn(_s, prm)$/;"	f
p.Flpy.save	gui/gui/flpy/prt/flpy/flpy.lua	/^function p.Flpy.save(_s)$/;"	f
p.Kzn.add	gui/gui/pc/prt/kzn/kzn.lua	/^function p.Kzn.add(name) -- name:hash$/;"	f
p.Kzn.cre	gui/gui/pc/prt/kzn/kzn.lua	/^function p.Kzn.cre(parent_gui)$/;"	f
p.Kzn.decide	gui/gui/pc/prt/kzn/kzn.lua	/^function p.Kzn.decide(_s)$/;"	f
p.Kzn.init	gui/gui/pc/prt/kzn/kzn.lua	/^function p.Kzn.init(_s, parent_gui)$/;"	f
p.Kzn.item_point__	gui/gui/pc/prt/kzn/kzn.lua	/^function p.Kzn.item_point__(_s)$/;"	f
p.Kzn.itm_icn__	gui/gui/pc/prt/kzn/kzn.lua	/^function p.Kzn.itm_icn__(_s)$/;"	f
p.Kzn.opn	gui/gui/pc/prt/kzn/kzn.lua	/^function p.Kzn.opn(_s, prm)$/;"	f
p.Logo.cre	gui/gui/title/prt/logo/logo.lua	/^function p.Logo.cre(parent_gui)$/;"	f
p.Logo.decide	gui/gui/title/prt/logo/logo.lua	/^function p.Logo.decide(_s)$/;"	f
p.Logo.init	gui/gui/title/prt/logo/logo.lua	/^function p.Logo.init(_s, parent_gui)$/;"	f
p.Logo.key_2_act	gui/gui/title/prt/logo/logo.lua	/^function p.Logo.key_2_act(_s, prm)$/;"	f
p.Logo.logo_dsp__	gui/gui/title/prt/logo/logo.lua	/^function p.Logo.logo_dsp__(_s, val)$/;"	f
p.Logo.opn	gui/gui/title/prt/logo/logo.lua	/^function p.Logo.opn(_s)$/;"	f
p.Logo.wakeup__	gui/gui/title/prt/logo/logo.lua	/^function p.Logo.wakeup__(_s, val)$/;"	f
p.Msg.clz	gui/gui/msg/prt/msg/msg.lua	/^function p.Msg.clz(_s)$/;"	f
p.Msg.cre	gui/gui/msg/prt/msg/msg.lua	/^function p.Msg.cre(parent_gui)$/;"	f
p.Msg.init	gui/gui/msg/prt/msg/msg.lua	/^function p.Msg.init(_s, parent_gui)$/;"	f
p.Msg.itm__add	gui/gui/msg/prt/msg/msg.lua	/^function p.Msg.itm__add(_s, itm)$/;"	f
p.Msg.itm__plt_anm	gui/gui/msg/prt/msg/msg.lua	/^function p.Msg.itm__plt_anm(_s)$/;"	f
p.Msg.opn	gui/gui/msg/prt/msg/msg.lua	/^function p.Msg.opn(_s)$/;"	f
p.Pc.cre	gui/gui/pc/prt/pc/pc.lua	/^function p.Pc.cre(parent_gui)$/;"	f
p.Pc.decide	gui/gui/pc/prt/pc/pc.lua	/^function p.Pc.decide(_s)$/;"	f
p.Pc.init	gui/gui/pc/prt/pc/pc.lua	/^function p.Pc.init(_s, parent_gui)$/;"	f
p.Pc.opn	gui/gui/pc/prt/pc/pc.lua	/^function p.Pc.opn(_s)$/;"	f
p.Ply_data.cre	gui/prt/ply_data/ply_data.lua	/^function p.Ply_data.cre(parent_gui)$/;"	f
p.Ply_data.cursor_data	gui/prt/ply_data/ply_data.lua	/^function p.Ply_data.cursor_data(_s)$/;"	f
p.Ply_data.cursor_ply_data_thmb	gui/prt/ply_data/ply_data.lua	/^function p.Ply_data.cursor_ply_data_thmb(_s)$/;"	f
p.Ply_data.cursor_ply_data_thmb_idx	gui/prt/ply_data/ply_data.lua	/^function p.Ply_data.cursor_ply_data_thmb_idx(_s)$/;"	f
p.Ply_data.decide	gui/prt/ply_data/ply_data.lua	/^function p.Ply_data.decide(_s)$/;"	f
p.Ply_data.game_continue	gui/prt/ply_data/ply_data.lua	/^function p.Ply_data.game_continue(_s)$/;"	f
p.Ply_data.init	gui/prt/ply_data/ply_data.lua	/^function p.Ply_data.init(_s, parent_gui)$/;"	f
p.Ply_data.is_emp_cursor_ply_data_thmb	gui/prt/ply_data/ply_data.lua	/^function p.Ply_data.is_emp_cursor_ply_data_thmb(_s)$/;"	f
p.Ply_data.itm_idx_2_ply_data_thmb_idx	gui/prt/ply_data/ply_data.lua	/^function p.Ply_data.itm_idx_2_ply_data_thmb_idx(_s, itm_idx)$/;"	f
p.Ply_data.opn	gui/prt/ply_data/ply_data.lua	/^function p.Ply_data.opn(_s, prm)$/;"	f
p.Ply_data.ply_data_file_idx_ltst	gui/prt/ply_data/ply_data.lua	/^function p.Ply_data.ply_data_file_idx_ltst(_s)$/;"	f
p.Ply_data.ply_data_file_idx_ltst__load	gui/prt/ply_data/ply_data.lua	/^function p.Ply_data.ply_data_file_idx_ltst__load(_s)$/;"	f
p.Ply_data.ply_data_thmb	gui/prt/ply_data/ply_data.lua	/^function p.Ply_data.ply_data_thmb(_s, idx)$/;"	f
p.Ply_data.ply_data_thmb__load	gui/prt/ply_data/ply_data.lua	/^function p.Ply_data.ply_data_thmb__load(_s)$/;"	f
p.Ply_data.ply_slt_idx	gui/prt/ply_data/ply_data.lua	/^function p.Ply_data.ply_slt_idx(_s)$/;"	f
p.Ply_data.ply_slt_idx__	gui/prt/ply_data/ply_data.lua	/^function p.Ply_data.ply_slt_idx__(_s, ply_slt_idx)$/;"	f
p.Ply_slt.clr	gui/gui/title/prt/ply_slt/ply_slt.lua	/^function p.Ply_slt.clr(_s, ply_slt_idx) -- todo refactoring fnc locale, loop logic$/;"	f
p.Ply_slt.cre	gui/gui/title/prt/ply_slt/ply_slt.lua	/^function p.Ply_slt.cre(parent_gui)$/;"	f
p.Ply_slt.cursor_mv	gui/gui/title/prt/ply_slt/ply_slt.lua	/^function p.Ply_slt.cursor_mv(_s, inp_dir, itm_scrl_dir, keyact)$/;"	f
p.Ply_slt.decide	gui/gui/title/prt/ply_slt/ply_slt.lua	/^function p.Ply_slt.decide(_s)$/;"	f
p.Ply_slt.game_new	gui/gui/title/prt/ply_slt/ply_slt.lua	/^function p.Ply_slt.game_new(_s)$/;"	f
p.Ply_slt.init	gui/gui/title/prt/ply_slt/ply_slt.lua	/^function p.Ply_slt.init(_s, parent_gui)$/;"	f
p.Ply_slt.inner_focus	gui/gui/title/prt/ply_slt/ply_slt.lua	/^function p.Ply_slt.inner_focus(_s)$/;"	f
p.Ply_slt.inner_focus__	gui/gui/title/prt/ply_slt/ply_slt.lua	/^function p.Ply_slt.inner_focus__(_s, inner_focus)$/;"	f
p.Ply_slt.is_inner_focus	gui/gui/title/prt/ply_slt/ply_slt.lua	/^function p.Ply_slt.is_inner_focus(_s, inner_focus)$/;"	f
p.Ply_slt.itm__	gui/gui/title/prt/ply_slt/ply_slt.lua	/^function p.Ply_slt.itm__(_s)$/;"	f
p.Ply_slt.itm__load	gui/gui/title/prt/ply_slt/ply_slt.lua	/^function p.Ply_slt.itm__load(_s, ply_slt_idx)$/;"	f
p.Ply_slt.nd_itm__	gui/gui/title/prt/ply_slt/ply_slt.lua	/^function p.Ply_slt.nd_itm__(_s)$/;"	f
p.Ply_slt.nd_itm_txt__	gui/gui/title/prt/ply_slt/ply_slt.lua	/^function p.Ply_slt.nd_itm_txt__(_s, idx)$/;"	f
p.Ply_slt.opn	gui/gui/title/prt/ply_slt/ply_slt.lua	/^function p.Ply_slt.opn(_s, prm)$/;"	f
p.Prt.actv__	gui/prt/prt/prt.lua	/^function p.Prt.actv__(_s, val)$/;"	f
p.Prt.actv__o	gui/prt/prt/prt.lua	/^function p.Prt.actv__o(_s)$/;"	f
p.Prt.actv__x	gui/prt/prt/prt.lua	/^function p.Prt.actv__x(_s)$/;"	f
p.Prt.arw_act	gui/prt/prt/prt.lua	/^function p.Prt.arw_act(_s, arwHa, keyact)$/;"	f
p.Prt.arw_act_othr	gui/prt/prt/prt.lua	/^function p.Prt.arw_act_othr(_s, inc_dir, keyact)$/;"	f
p.Prt.behind	gui/prt/prt/prt.lua	/^function p.Prt.behind(_s, fin)$/;"	f
p.Prt.clz	gui/prt/prt/prt.lua	/^function p.Prt.clz(_s, se_off)$/;"	f
p.Prt.confirm	gui/prt/prt/prt.lua	/^function p.Prt.confirm(_s)$/;"	f
p.Prt.confirm_opn	gui/prt/prt/prt.lua	/^function p.Prt.confirm_opn(_s)$/;"	f
p.Prt.cre	gui/prt/prt/prt.lua	/^function p.Prt.cre(p_Prt, parent_gui)$/;"	f
p.Prt.cursor_itm_opt_ch	gui/prt/prt/prt.lua	/^function p.Prt.cursor_itm_opt_ch(_s, inc_dir)$/;"	f
p.Prt.exe	gui/prt/prt/prt.lua	/^function p.Prt.exe(_s)$/;"	f
p.Prt.exe__	gui/prt/prt/prt.lua	/^function p.Prt.exe__(_s, exe)$/;"	f
p.Prt.focus__	gui/prt/prt/prt.lua	/^function p.Prt.focus__(_s, val)$/;"	f
p.Prt.init	gui/prt/prt/prt.lua	/^function p.Prt.init(_s, parent_gui)$/;"	f
p.Prt.inner_focus	gui/prt/prt/prt.lua	/^function p.Prt.inner_focus(_s)$/;"	f
p.Prt.inner_focus__	gui/prt/prt/prt.lua	/^function p.Prt.inner_focus__(_s, inner_focus)$/;"	f
p.Prt.is_inner_focus	gui/prt/prt/prt.lua	/^function p.Prt.is_inner_focus(_s, inner_focus)$/;"	f
p.Prt.is_key_arw	gui/prt/prt/prt.lua	/^function p.Prt.is_key_arw(_s, key, keyact)$/;"	f
p.Prt.key_2_act	gui/prt/prt/prt.lua	/^function p.Prt.key_2_act(_s, prm)$/;"	f
p.Prt.key_2_act_itm	gui/prt/prt/prt.lua	/^function p.Prt.key_2_act_itm(_s, prm)$/;"	f
p.Prt.lb	gui/prt/prt/prt.lua	/^function p.Prt.lb(_s, nd_lb)$/;"	f
p.Prt.nd	gui/prt/prt/prt.lua	/^function p.Prt.nd(_s, nd_lb)$/;"	f
p.Prt.nd__	gui/prt/prt/prt.lua	/^function p.Prt.nd__(_s, nd_lb)$/;"	f
p.Prt.nd_dsp_0s__	gui/prt/prt/prt.lua	/^function p.Prt.nd_dsp_0s__(_s, nd_lb, val)$/;"	f
p.Prt.nd_dsp__	gui/prt/prt/prt.lua	/^function p.Prt.nd_dsp__(_s, nd_lb, val, fin, time)$/;"	f
p.Prt.nd_dsp__o	gui/prt/prt/prt.lua	/^function p.Prt.nd_dsp__o(_s, nd_lb, fin, time)$/;"	f
p.Prt.nd_dsp__x	gui/prt/prt/prt.lua	/^function p.Prt.nd_dsp__x(_s, nd_lb, fin, time)$/;"	f
p.Prt.nd_pos	gui/prt/prt/prt.lua	/^function p.Prt.nd_pos(_s, nd_lb)$/;"	f
p.Prt.parent_gui_del	gui/prt/prt/prt.lua	/^function p.Prt.parent_gui_del(_s)$/;"	f
p.Prt.parent_gui_hndl__add	gui/prt/prt/prt.lua	/^function p.Prt.parent_gui_hndl__add(_s, hndl)$/;"	f
p.Prt.url	gui/prt/prt/prt.lua	/^function p.Prt.url(_s)$/;"	f
p.Prt_base.base_dsp_0s__	gui/prt/prt/prt_base.lua	/^function p.Prt_base.base_dsp_0s__(_s, val)$/;"	f
p.Prt_base.base_dsp_0s__o	gui/prt/prt/prt_base.lua	/^function p.Prt_base.base_dsp_0s__o(_s)$/;"	f
p.Prt_base.base_dsp_0s__x	gui/prt/prt/prt_base.lua	/^function p.Prt_base.base_dsp_0s__x(_s)$/;"	f
p.Prt_base.base_dsp__	gui/prt/prt/prt_base.lua	/^function p.Prt_base.base_dsp__(_s, val, fin, time)$/;"	f
p.Prt_base.base_dsp__o	gui/prt/prt/prt_base.lua	/^function p.Prt_base.base_dsp__o(_s, time)$/;"	f
p.Prt_base.base_dsp__x	gui/prt/prt/prt_base.lua	/^function p.Prt_base.base_dsp__x(_s, time)$/;"	f
p.Prt_base.base_pos__	gui/prt/prt/prt_base.lua	/^function p.Prt_base.base_pos__(_s, p_pos)$/;"	f
p.Prt_base.base_pos__center	gui/prt/prt/prt_base.lua	/^function p.Prt_base.base_pos__center(_s)$/;"	f
p.Prt_base.init	gui/prt/prt/prt_base.lua	/^function p.Prt_base.init(_s)$/;"	f
p.Prt_cursor.actv__	gui/prt/prt/prt_cursor.lua	/^function p.Prt_cursor.actv__(_s, val)$/;"	f
p.Prt_cursor.cursor__plt_anm	gui/prt/prt/prt_cursor.lua	/^function p.Prt_cursor.cursor__plt_anm(_s)$/;"	f
p.Prt_cursor.cursor_dsp__	gui/prt/prt/prt_cursor.lua	/^function p.Prt_cursor.cursor_dsp__(_s, val)$/;"	f
p.Prt_cursor.cursor_dsp__o	gui/prt/prt/prt_cursor.lua	/^function p.Prt_cursor.cursor_dsp__o(_s)$/;"	f
p.Prt_cursor.cursor_dsp__x	gui/prt/prt/prt_cursor.lua	/^function p.Prt_cursor.cursor_dsp__x(_s)$/;"	f
p.Prt_cursor.cursor_itm	gui/prt/prt/prt_cursor.lua	/^function p.Prt_cursor.cursor_itm(_s)$/;"	f
p.Prt_cursor.cursor_itm_idx	gui/prt/prt/prt_cursor.lua	/^function p.Prt_cursor.cursor_itm_idx(_s)$/;"	f
p.Prt_cursor.cursor_itm_iyaiya	gui/prt/prt/prt_cursor.lua	/^function p.Prt_cursor.cursor_itm_iyaiya(_s)$/;"	f
p.Prt_cursor.cursor_itm_nd	gui/prt/prt/prt_cursor.lua	/^function p.Prt_cursor.cursor_itm_nd(_s, nd_id)$/;"	f
p.Prt_cursor.cursor_itm_nd_ar	gui/prt/prt/prt_cursor.lua	/^function p.Prt_cursor.cursor_itm_nd_ar(_s)$/;"	f
p.Prt_cursor.cursor_itm_opt_ch	gui/prt/prt/prt_cursor.lua	/^function p.Prt_cursor.cursor_itm_opt_ch(_s, dir)$/;"	f
p.Prt_cursor.cursor_itm_poyon	gui/prt/prt/prt_cursor.lua	/^function p.Prt_cursor.cursor_itm_poyon(_s, fin)$/;"	f
p.Prt_cursor.cursor_mv	gui/prt/prt/prt_cursor.lua	/^function p.Prt_cursor.cursor_mv(_s, inc_dir, keyact)$/;"	f
p.Prt_cursor.cursor_mv_exe	gui/prt/prt/prt_cursor.lua	/^function p.Prt_cursor.cursor_mv_exe(_s)$/;"	f
p.Prt_cursor.cursor_mv_loop	gui/prt/prt/prt_cursor.lua	/^function p.Prt_cursor.cursor_mv_loop(_s, inc_dir)$/;"	f
p.Prt_cursor.cursor_nd	gui/prt/prt/prt_cursor.lua	/^function p.Prt_cursor.cursor_nd(_s)$/;"	f
p.Prt_cursor.cursor_pos	gui/prt/prt/prt_cursor.lua	/^function p.Prt_cursor.cursor_pos(_s)$/;"	f
p.Prt_cursor.cursor_pos__	gui/prt/prt/prt_cursor.lua	/^function p.Prt_cursor.cursor_pos__(_s)$/;"	f
p.Prt_cursor.init	gui/prt/prt/prt_cursor.lua	/^function p.Prt_cursor.init(_s)$/;"	f
p.Prt_cursor.is_cursor_mv	gui/prt/prt/prt_cursor.lua	/^function p.Prt_cursor.is_cursor_mv(_s, arwHa)$/;"	f
p.Prt_cursor_mtrx.cursor_mv	gui/prt/prt/prt_cursor_mtrx.lua	/^function p.Prt_cursor_mtrx.cursor_mv(_s, dir)$/;"	f
p.Prt_cursor_mtrx.cursor_pos__	gui/prt/prt/prt_cursor_mtrx.lua	/^function p.Prt_cursor_mtrx.cursor_pos__(_s)$/;"	f
p.Prt_cursor_mtrx.init	gui/prt/prt/prt_cursor_mtrx.lua	/^function p.Prt_cursor_mtrx.init(_s)$/;"	f
p.Prt_cursor_mtrx.is_cursor_mv	gui/prt/prt/prt_cursor_mtrx.lua	/^function p.Prt_cursor_mtrx.is_cursor_mv(_s, arwHa)$/;"	f
p.Prt_itm.dsp1_itm_idx_max__	gui/prt/prt/prt_itm.lua	/^function p.Prt_itm.dsp1_itm_idx_max__(_s)$/;"	f
p.Prt_itm.dspE_itm_idx	gui/prt/prt/prt_itm.lua	/^function p.Prt_itm.dspE_itm_idx(_s)$/;"	f
p.Prt_itm.dsp_idx_by_itm_idx	gui/prt/prt/prt_itm.lua	/^function p.Prt_itm.dsp_idx_by_itm_idx(_s, itm_idx) -- alias$/;"	f
p.Prt_itm.dsp_itm_rng	gui/prt/prt/prt_itm.lua	/^function p.Prt_itm.dsp_itm_rng(_s)$/;"	f
p.Prt_itm.init	gui/prt/prt/prt_itm.lua	/^function p.Prt_itm.init(_s)$/;"	f
p.Prt_itm.is_dsp_itm_1	gui/prt/prt/prt_itm.lua	/^function p.Prt_itm.is_dsp_itm_1(_s)$/;"	f
p.Prt_itm.is_dsp_itm_E	gui/prt/prt/prt_itm.lua	/^function p.Prt_itm.is_dsp_itm_E(_s)$/;"	f
p.Prt_itm.is_itm_dsp_by_idx	gui/prt/prt/prt_itm.lua	/^function p.Prt_itm.is_itm_dsp_by_idx(_s, itm_idx)$/;"	f
p.Prt_itm.itm	gui/prt/prt/prt_itm.lua	/^function p.Prt_itm.itm(_s, itm_idx)$/;"	f
p.Prt_itm.itmE_nd	gui/prt/prt/prt_itm.lua	/^function p.Prt_itm.itmE_nd(_s)$/;"	f
p.Prt_itm.itm__add	gui/prt/prt/prt_itm.lua	/^function p.Prt_itm.itm__add(_s, itm)$/;"	f
p.Prt_itm.itm__by_ar	gui/prt/prt/prt_itm.lua	/^function p.Prt_itm.itm__by_ar(_s, p_ar)$/;"	f
p.Prt_itm.itm__by_ar_lim	gui/prt/prt/prt_itm.lua	/^function p.Prt_itm.itm__by_ar_lim(_s, p_ar)$/;"	f
p.Prt_itm.itm__by_idx	gui/prt/prt/prt_itm.lua	/^function p.Prt_itm.itm__by_idx(_s, prefix, idx_max)$/;"	f
p.Prt_itm.itm__del_1	gui/prt/prt/prt_itm.lua	/^function p.Prt_itm.itm__del_1(_s)$/;"	f
p.Prt_itm.itm__plt	gui/prt/prt/prt_itm.lua	/^function p.Prt_itm.itm__plt(_s)$/;"	f
p.Prt_itm.itm__plt_anm	gui/prt/prt/prt_itm.lua	/^function p.Prt_itm.itm__plt_anm(_s)$/;"	f
p.Prt_itm.itm__plt_by_idx	gui/prt/prt/prt_itm.lua	/^function p.Prt_itm.itm__plt_by_idx(_s, itm_idx)$/;"	f
p.Prt_itm.itm_clone	gui/prt/prt/prt_itm.lua	/^function p.Prt_itm.itm_clone(_s)$/;"	f
p.Prt_itm.itm_dsp__	gui/prt/prt/prt_itm.lua	/^function p.Prt_itm.itm_dsp__(_s, val)$/;"	f
p.Prt_itm.itm_dsp__by_idx	gui/prt/prt/prt_itm.lua	/^function p.Prt_itm.itm_dsp__by_idx(_s, itm_idx, val)$/;"	f
p.Prt_itm.itm_dsp__x	gui/prt/prt/prt_itm.lua	/^function p.Prt_itm.itm_dsp__x(_s)$/;"	f
p.Prt_itm.itm_idx_2_dsp_idx	gui/prt/prt/prt_itm.lua	/^function p.Prt_itm.itm_idx_2_dsp_idx(_s, itm_idx)$/;"	f
p.Prt_itm.itm_idx_max	gui/prt/prt/prt_itm.lua	/^function p.Prt_itm.itm_idx_max(_s)$/;"	f
p.Prt_itm.itm_idx_max__	gui/prt/prt/prt_itm.lua	/^function p.Prt_itm.itm_idx_max__(_s)$/;"	f
p.Prt_itm.itm_nd	gui/prt/prt/prt_itm.lua	/^function p.Prt_itm.itm_nd(_s, itm_idx)$/;"	f
p.Prt_itm.itm_pos__by_idx	gui/prt/prt/prt_itm.lua	/^function p.Prt_itm.itm_pos__by_idx(_s, itm_idx)$/;"	f
p.Prt_itm.itm_pos__tpl_by_idx	gui/prt/prt/prt_itm.lua	/^function p.Prt_itm.itm_pos__tpl_by_idx(_s, itm_idx)$/;"	f
p.Prt_itm_lst.init	gui/prt/prt/prt_itm_lst.lua	/^function p.Prt_itm_lst.init(_s)$/;"	f
p.Prt_itm_lst.itm_pos_by_dsp_idx	gui/prt/prt/prt_itm_lst.lua	/^function p.Prt_itm_lst.itm_pos_by_dsp_idx(_s, dsp_idx)$/;"	f
p.Prt_itm_lst.itm_scrl	gui/prt/prt/prt_itm_lst.lua	/^function p.Prt_itm_lst.itm_scrl(_s, inc_dir)$/;"	f
p.Prt_itm_menu.init	gui/prt/prt/prt_itm_menu.lua	/^function p.Prt_itm_menu.init(_s)$/;"	f
p.Prt_itm_menu.itm_menu	gui/prt/prt/prt_itm_menu.lua	/^function p.Prt_itm_menu.itm_menu(_s)$/;"	f
p.Prt_itm_menu.itm_menu_actv__o	gui/prt/prt/prt_itm_menu.lua	/^function p.Prt_itm_menu.itm_menu_actv__o(_s)$/;"	f
p.Prt_itm_menu.itm_menu_actv__x	gui/prt/prt/prt_itm_menu.lua	/^function p.Prt_itm_menu.itm_menu_actv__x(_s)$/;"	f
p.Prt_itm_menu.itm_menu_arw_act	gui/prt/prt/prt_itm_menu.lua	/^function p.Prt_itm_menu.itm_menu_arw_act(_s, prm)$/;"	f
p.Prt_itm_menu.itm_menu_clz	gui/prt/prt/prt_itm_menu.lua	/^function p.Prt_itm_menu.itm_menu_clz(_s)$/;"	f
p.Prt_itm_menu.itm_menu_cursor_mv	gui/prt/prt/prt_itm_menu.lua	/^function p.Prt_itm_menu.itm_menu_cursor_mv(_s, prm)$/;"	f
p.Prt_itm_menu.itm_menu_decide	gui/prt/prt/prt_itm_menu.lua	/^function p.Prt_itm_menu.itm_menu_decide(_s)$/;"	f
p.Prt_itm_menu.itm_menu_dsp__	gui/prt/prt/prt_itm_menu.lua	/^function p.Prt_itm_menu.itm_menu_dsp__(_s, val)$/;"	f
p.Prt_itm_menu.itm_menu_exe	gui/prt/prt/prt_itm_menu.lua	/^function p.Prt_itm_menu.itm_menu_exe(_s) -- refactoring$/;"	f
p.Prt_itm_menu.itm_menu_icn_dsp__	gui/prt/prt/prt_itm_menu.lua	/^function p.Prt_itm_menu.itm_menu_icn_dsp__(_s, val)$/;"	f
p.Prt_itm_menu.itm_menu_icn_dsp__auto	gui/prt/prt/prt_itm_menu.lua	/^function p.Prt_itm_menu.itm_menu_icn_dsp__auto(_s)$/;"	f
p.Prt_itm_menu.itm_menu_opn	gui/prt/prt/prt_itm_menu.lua	/^function p.Prt_itm_menu.itm_menu_opn(_s)$/;"	f
p.Prt_itm_menu.key_2_act_itm_menu	gui/prt/prt/prt_itm_menu.lua	/^function p.Prt_itm_menu.key_2_act_itm_menu(_s, prm)$/;"	f
p.Prt_itm_menu.nd_itm_menu__	gui/prt/prt/prt_itm_menu.lua	/^function p.Prt_itm_menu.nd_itm_menu__(_s)$/;"	f
p.Prt_itm_mtrx.dsp1_itm_idx__	gui/prt/prt/prt_itm_mtrx.lua	/^function p.Prt_itm_mtrx.dsp1_itm_idx__(_s)$/;"	f
p.Prt_itm_mtrx.dsp_idx_max__	gui/prt/prt/prt_itm_mtrx.lua	/^function p.Prt_itm_mtrx.dsp_idx_max__(_s)$/;"	f
p.Prt_itm_mtrx.init	gui/prt/prt/prt_itm_mtrx.lua	/^function p.Prt_itm_mtrx.init(_s)$/;"	f
p.Prt_itm_mtrx.is_edge	gui/prt/prt/prt_cursor_mtrx.lua	/^function p.Prt_itm_mtrx.is_edge(_s, edge)$/;"	f
p.Prt_itm_mtrx.itm_pos_by_dsp_idx	gui/prt/prt/prt_itm_mtrx.lua	/^function p.Prt_itm_mtrx.itm_pos_by_dsp_idx(_s, dsp_idx)$/;"	f
p.Prt_itm_mtrx.page__plt	gui/prt/prt/prt_itm_mtrx.lua	/^function p.Prt_itm_mtrx.page__plt(_s)$/;"	f
p.Prt_itm_mtrx.page_idx__mv	gui/prt/prt/prt_itm_mtrx.lua	/^function p.Prt_itm_mtrx.page_idx__mv(_s, dir)$/;"	f
p.Prt_itm_mtrx.page_idx_max__	gui/prt/prt/prt_itm_mtrx.lua	/^function p.Prt_itm_mtrx.page_idx_max__(_s)$/;"	f
p.Prt_itm_mtrx.page_mv	gui/prt/prt/prt_itm_mtrx.lua	/^function p.Prt_itm_mtrx.page_mv(_s, dir)$/;"	f
p.Prt_itm_opt.arw_act_othr	gui/prt/prt/prt_itm_opt.lua	/^function p.Prt_itm_opt.arw_act_othr(_s, inc_dir, keyact)$/;"	f
p.Prt_itm_opt.cursor_itm_opt	gui/prt/prt/prt_itm_opt.lua	/^function p.Prt_itm_opt.cursor_itm_opt(_s)$/;"	f
p.Prt_itm_opt.cursor_itm_opt__	gui/prt/prt/prt_itm_opt.lua	/^function p.Prt_itm_opt.cursor_itm_opt__(_s, val)$/;"	f
p.Prt_itm_opt.cursor_itm_opt_ch	gui/prt/prt/prt_itm_opt.lua	/^function p.Prt_itm_opt.cursor_itm_opt_ch(_s, dir)$/;"	f
p.Prt_itm_opt.cursor_itm_opt_ch	gui/prt/prt/prt_itm_opt.lua	/^function p.Prt_itm_opt.cursor_itm_opt_ch(_s, inc_dir)$/;"	f
p.Prt_itm_opt.init	gui/prt/prt/prt_itm_opt.lua	/^function p.Prt_itm_opt.init(_s)$/;"	f
p.Prt_selected.init	gui/prt/prt/prt_selected.lua	/^function p.Prt_selected.init(_s)$/;"	f
p.Prt_selected.is_selected_dsp	gui/prt/prt/prt_selected.lua	/^function p.Prt_selected.is_selected_dsp(_s)$/;"	f
p.Prt_selected.is_selected_eq_cursor	gui/prt/prt/prt_selected.lua	/^function p.Prt_selected.is_selected_eq_cursor(_s)$/;"	f
p.Prt_selected.selected__cursor_itm	gui/prt/prt/prt_selected.lua	/^function p.Prt_selected.selected__cursor_itm(_s)$/;"	f
p.Prt_selected.selected_drw	gui/prt/prt/prt_selected.lua	/^function p.Prt_selected.selected_drw(_s)$/;"	f
p.Prt_selected.selected_dsp__o	gui/prt/prt/prt_selected.lua	/^function p.Prt_selected.selected_dsp__o(_s)$/;"	f
p.Prt_selected.selected_dsp__x	gui/prt/prt/prt_selected.lua	/^function p.Prt_selected.selected_dsp__x(_s)$/;"	f
p.Prt_selected.selected_dsp_idx	gui/prt/prt/prt_selected.lua	/^function p.Prt_selected.selected_dsp_idx(_s)$/;"	f
p.Prt_selected.selected_itm	gui/prt/prt/prt_selected.lua	/^function p.Prt_selected.selected_itm(_s)$/;"	f
p.Prt_selected.selected_itm_idx	gui/prt/prt/prt_selected.lua	/^function p.Prt_selected.selected_itm_idx(_s)$/;"	f
p.Prt_selected.selected_itm_idx__	gui/prt/prt/prt_selected.lua	/^function p.Prt_selected.selected_itm_idx__(_s, itm_idx)$/;"	f
p.Prt_selected.selected_nd	gui/prt/prt/prt_selected.lua	/^function p.Prt_selected.selected_nd(_s)$/;"	f
p.Prt_selected.selected_nd_parent__	gui/prt/prt/prt_selected.lua	/^function p.Prt_selected.selected_nd_parent__(_s, p_parent_nd)$/;"	f
p.Prt_selected.selected_pos	gui/prt/prt/prt_selected.lua	/^function p.Prt_selected.selected_pos(_s)$/;"	f
p.Prt_selected.selected_pos__	gui/prt/prt/prt_selected.lua	/^function p.Prt_selected.selected_pos__(_s, p_pos)$/;"	f
p.Reizoko.clz	gui/gui/reizoko/prt/reizoko/reizoko.lua	/^function p.Reizoko.clz(_s)$/;"	f
p.Reizoko.cre	gui/gui/reizoko/prt/reizoko/reizoko.lua	/^function p.Reizoko.cre(parent_gui)$/;"	f
p.Reizoko.decide	gui/gui/reizoko/prt/reizoko/reizoko.lua	/^function p.Reizoko.decide(_s)$/;"	f
p.Reizoko.food__del	gui/gui/reizoko/prt/reizoko/reizoko.lua	/^function p.Reizoko.food__del(_s)$/;"	f
p.Reizoko.food_cre	gui/gui/reizoko/prt/reizoko/reizoko.lua	/^function p.Reizoko.food_cre(_s)$/;"	f
p.Reizoko.init	gui/gui/reizoko/prt/reizoko/reizoko.lua	/^function p.Reizoko.init(_s, parent_gui)$/;"	f
p.Reizoko.opn	gui/gui/reizoko/prt/reizoko/reizoko.lua	/^function p.Reizoko.opn(_s)$/;"	f
p.Shelf.cre	gui/gui/shelf/prt/shelf/shelf.lua	/^function p.Shelf.cre(parent_gui)$/;"	f
p.Shelf.decide	gui/gui/shelf/prt/shelf/shelf.lua	/^function p.Shelf.decide(_s)$/;"	f
p.Shelf.init	gui/gui/shelf/prt/shelf/shelf.lua	/^function p.Shelf.init(_s, parent_gui)$/;"	f
p.Shelf.opn	gui/gui/shelf/prt/shelf/shelf.lua	/^function p.Shelf.opn(_s)$/;"	f
p.Shelf.restore	gui/gui/shelf/prt/shelf/shelf.lua	/^function p.Shelf.restore(_s) -- use?$/;"	f
p.Shop.cre	gui/gui/pc/prt/shop/shop/shop.lua	/^function p.Shop.cre(parent_gui)$/;"	f
p.Shop.decide	gui/gui/pc/prt/shop/shop/shop.lua	/^function p.Shop.decide(_s)$/;"	f
p.Shop.init	gui/gui/pc/prt/shop/shop/shop.lua	/^function p.Shop.init(_s, parent_gui)$/;"	f
p.Shop.opn	gui/gui/pc/prt/shop/shop/shop.lua	/^function p.Shop.opn(_s, prm)$/;"	f
p.Shop_block.cre	gui/gui/pc/prt/shop/block/block.lua	/^function p.Shop_block.cre(parent_gui)$/;"	f
p.Shop_block.decide	gui/gui/pc/prt/shop/block/block.lua	/^function p.Shop_block.decide(_s)$/;"	f
p.Shop_block.init	gui/gui/pc/prt/shop/block/block.lua	/^function p.Shop_block.init(_s, parent_gui)$/;"	f
p.Shop_flower.cre	gui/gui/pc/prt/shop/flower/flower.lua	/^function p.Shop_flower.cre(parent_gui)$/;"	f
p.Shop_flower.cursor_itm_price	gui/gui/pc/prt/shop/flower/flower.lua	/^function p.Shop_flower.cursor_itm_price(_s)$/;"	f
p.Shop_flower.decide	gui/gui/pc/prt/shop/flower/flower.lua	/^function p.Shop_flower.decide(_s)$/;"	f
p.Shop_flower.exe	gui/gui/pc/prt/shop/flower/flower.lua	/^function p.Shop_flower.exe(_s)$/;"	f
p.Shop_flower.init	gui/gui/pc/prt/shop/flower/flower.lua	/^function p.Shop_flower.init(_s, parent_gui)$/;"	f
p.Shop_flower.is_cursor_itm_buyable	gui/gui/pc/prt/shop/flower/flower.lua	/^function p.Shop_flower.is_cursor_itm_buyable(_s)$/;"	f
p.Shop_flower.opn	gui/gui/pc/prt/shop/flower/flower.lua	/^function p.Shop_flower.opn(_s, prm)$/;"	f
p.Shop_flower.ply_data_gold__	gui/gui/pc/prt/shop/flower/flower.lua	/^function p.Shop_flower.ply_data_gold__(_s)$/;"	f
p.Shop_kagu.cre	gui/gui/pc/prt/shop/kagu/kagu.lua	/^function p.Shop_kagu.cre(parent_gui)$/;"	f
p.Shop_kagu.cursor_itm_cls_name	gui/gui/pc/prt/shop/kagu/kagu.lua	/^function p.Shop_kagu.cursor_itm_cls_name(_s)$/;"	f
p.Shop_kagu.cursor_itm_price	gui/gui/pc/prt/shop/kagu/kagu.lua	/^function p.Shop_kagu.cursor_itm_price(_s)$/;"	f
p.Shop_kagu.decide	gui/gui/pc/prt/shop/kagu/kagu.lua	/^function p.Shop_kagu.decide(_s)$/;"	f
p.Shop_kagu.exe	gui/gui/pc/prt/shop/kagu/kagu.lua	/^function p.Shop_kagu.exe(_s)$/;"	f
p.Shop_kagu.init	gui/gui/pc/prt/shop/kagu/kagu.lua	/^function p.Shop_kagu.init(_s, parent_gui)$/;"	f
p.Shop_kagu.is_item_buyable	gui/gui/pc/prt/shop/kagu/kagu.lua	/^function p.Shop_kagu.is_item_buyable(_s)$/;"	f
p.Shop_kagu.opn	gui/gui/pc/prt/shop/kagu/kagu.lua	/^function p.Shop_kagu.opn(_s, prm)$/;"	f
p.Shop_kagu.ply_data_gold__	gui/gui/pc/prt/shop/kagu/kagu.lua	/^function p.Shop_kagu.ply_data_gold__(_s)$/;"	f
p.Shop_kagu_itm.cre	gui/gui/pc/prt/shop/kagu_itm/kagu_itm.lua	/^function p.Shop_kagu_itm.cre(parent_gui)$/;"	f
p.Shop_kagu_itm.cursor_itm_cls_name	gui/gui/pc/prt/shop/kagu_itm/kagu_itm.lua	/^function p.Shop_kagu_itm.cursor_itm_cls_name(_s)$/;"	f
p.Shop_kagu_itm.cursor_itm_price	gui/gui/pc/prt/shop/kagu_itm/kagu_itm.lua	/^function p.Shop_kagu_itm.cursor_itm_price(_s)$/;"	f
p.Shop_kagu_itm.decide	gui/gui/pc/prt/shop/kagu_itm/kagu_itm.lua	/^function p.Shop_kagu_itm.decide(_s)$/;"	f
p.Shop_kagu_itm.exe	gui/gui/pc/prt/shop/kagu_itm/kagu_itm.lua	/^function p.Shop_kagu_itm.exe(_s)$/;"	f
p.Shop_kagu_itm.init	gui/gui/pc/prt/shop/kagu_itm/kagu_itm.lua	/^function p.Shop_kagu_itm.init(_s, parent_gui)$/;"	f
p.Shop_kagu_itm.is_cursor_itm_buyable	gui/gui/pc/prt/shop/kagu_itm/kagu_itm.lua	/^function p.Shop_kagu_itm.is_cursor_itm_buyable(_s)$/;"	f
p.Shop_kagu_itm.opn	gui/gui/pc/prt/shop/kagu_itm/kagu_itm.lua	/^function p.Shop_kagu_itm.opn(_s, prm)$/;"	f
p.Shop_kagu_itm.ply_data_gold__	gui/gui/pc/prt/shop/kagu_itm/kagu_itm.lua	/^function p.Shop_kagu_itm.ply_data_gold__(_s)$/;"	f
p.Shop_kagu_itm.price	gui/gui/pc/prt/shop/kagu_itm/kagu_itm.lua	/^function p.Shop_kagu_itm.price(_s, cls, name)$/;"	f
p.Shop_tree.cre	gui/gui/pc/prt/shop/tree/tree.lua	/^function p.Shop_tree.cre(parent_gui)$/;"	f
p.Shop_tree.cursor_itm_cls_name	gui/gui/pc/prt/shop/tree/tree.lua	/^function p.Shop_tree.cursor_itm_cls_name(_s)$/;"	f
p.Shop_tree.cursor_itm_price	gui/gui/pc/prt/shop/tree/tree.lua	/^function p.Shop_tree.cursor_itm_price(_s)$/;"	f
p.Shop_tree.cursor_itm_prm	gui/gui/pc/prt/shop/tree/tree.lua	/^function p.Shop_tree.cursor_itm_prm(_s)$/;"	f
p.Shop_tree.decide	gui/gui/pc/prt/shop/tree/tree.lua	/^function p.Shop_tree.decide(_s)$/;"	f
p.Shop_tree.exe	gui/gui/pc/prt/shop/tree/tree.lua	/^function p.Shop_tree.exe(_s)$/;"	f
p.Shop_tree.init	gui/gui/pc/prt/shop/tree/tree.lua	/^function p.Shop_tree.init(_s, parent_gui)$/;"	f
p.Shop_tree.is_cursor_itm_buyable	gui/gui/pc/prt/shop/tree/tree.lua	/^function p.Shop_tree.is_cursor_itm_buyable(_s)$/;"	f
p.Shop_tree.opn	gui/gui/pc/prt/shop/tree/tree.lua	/^function p.Shop_tree.opn(_s, prm)$/;"	f
p.Shop_tree.ply_data_gold__	gui/gui/pc/prt/shop/tree/tree.lua	/^function p.Shop_tree.ply_data_gold__(_s)$/;"	f
p.Snn_dtl.cre	gui/gui/pc/prt/snn/snn_dtl/snn_dtl.lua	/^function p.Snn_dtl.cre(parent_gui)$/;"	f
p.Snn_dtl.decide	gui/gui/pc/prt/snn/snn_dtl/snn_dtl.lua	/^function p.Snn_dtl.decide(_s)$/;"	f
p.Snn_dtl.init	gui/gui/pc/prt/snn/snn_dtl/snn_dtl.lua	/^function p.Snn_dtl.init(_s, parent_gui)$/;"	f
p.Snn_dtl.opn	gui/gui/pc/prt/snn/snn_dtl/snn_dtl.lua	/^function p.Snn_dtl.opn(_s, prm)$/;"	f
p.Snn_lst.cre	gui/gui/pc/prt/snn/snn_lst/snn_lst.lua	/^function p.Snn_lst.cre(parent_gui)$/;"	f
p.Snn_lst.decide	gui/gui/pc/prt/snn/snn_lst/snn_lst.lua	/^function p.Snn_lst.decide(_s)$/;"	f
p.Snn_lst.init	gui/gui/pc/prt/snn/snn_lst/snn_lst.lua	/^function p.Snn_lst.init(_s, parent_gui)$/;"	f
p.Snn_lst.opn	gui/gui/pc/prt/snn/snn_lst/snn_lst.lua	/^function p.Snn_lst.opn(_s, prm)$/;"	f
p.Zu_animal.animal__o	gui/gui/shelf/prt/animal/zu_animal.lua	/^function p.Zu_animal.animal__o(name)$/;"	f
p.Zu_animal.cre	gui/gui/shelf/prt/animal/zu_animal.lua	/^function p.Zu_animal.cre(parent_gui)$/;"	f
p.Zu_animal.decide	gui/gui/shelf/prt/animal/zu_animal.lua	/^function p.Zu_animal.decide(_s)$/;"	f
p.Zu_animal.init	gui/gui/shelf/prt/animal/zu_animal.lua	/^function p.Zu_animal.init(_s, parent_gui)$/;"	f
p.Zu_animal.is_favo	gui/gui/shelf/prt/animal/zu_animal.lua	/^function p.Zu_animal.is_favo(name, o_cls, o_name)$/;"	f
p.Zu_animal.itm_icn__	gui/gui/shelf/prt/animal/zu_animal.lua	/^function p.Zu_animal.itm_icn__(_s)$/;"	f
p.Zu_animal.opn	gui/gui/shelf/prt/animal/zu_animal.lua	/^function p.Zu_animal.opn(_s, prm)$/;"	f
p.Zu_dish.cre	gui/gui/shelf/prt/dish/zu_dish.lua	/^function p.Zu_dish.cre(parent_gui)$/;"	f
p.Zu_dish.decide	gui/gui/shelf/prt/dish/zu_dish.lua	/^function p.Zu_dish.decide(_s)$/;"	f
p.Zu_dish.init	gui/gui/shelf/prt/dish/zu_dish.lua	/^function p.Zu_dish.init(_s, parent_gui)$/;"	f
p.Zu_dish.itm_icn__	gui/gui/shelf/prt/dish/zu_dish.lua	/^function p.Zu_dish.itm_icn__(_s)$/;"	f
p.Zu_dish.opn	gui/gui/shelf/prt/dish/zu_dish.lua	/^function p.Zu_dish.opn(_s, prm)$/;"	f
p.Zu_flower.cre	gui/gui/shelf/prt/flower/zu_flower.lua	/^function p.Zu_flower.cre(parent_gui)$/;"	f
p.Zu_flower.decide	gui/gui/shelf/prt/flower/zu_flower.lua	/^function p.Zu_flower.decide(_s)$/;"	f
p.Zu_flower.init	gui/gui/shelf/prt/flower/zu_flower.lua	/^function p.Zu_flower.init(_s, parent_gui)$/;"	f
p.Zu_flower.itm_icn__	gui/gui/shelf/prt/flower/zu_flower.lua	/^function p.Zu_flower.itm_icn__(_s)$/;"	f
p.Zu_flower.opn	gui/gui/shelf/prt/flower/zu_flower.lua	/^function p.Zu_flower.opn(_s, prm)$/;"	f
page._	etc/lua/page.lua	/^function page._(itm_idx, dsp_idx_max)$/;"	f
page.dsp1_itm_idx	etc/lua/page.lua	/^function page.dsp1_itm_idx(page_idx, dsp_idx_max)$/;"	f
page.itm_idx_2_page_idx	etc/lua/page.lua	/^function page.itm_idx_2_page_idx(itm_idx, dsp_idx_max) -- alias$/;"	f
page.itm_idx_rng	etc/lua/page.lua	/^function page.itm_idx_rng(page_idx, dsp_idx_max)$/;"	f
page.page_idx_max	etc/lua/page.lua	/^function page.page_idx_max(itm_idx_max, dsp_idx_max)$/;"	f
pos._	etc/lua/pos.lua	/^function pos._(id)$/;"	f
pos.by_id	etc/lua/pos.lua	/^function pos.by_id(id)$/;"	f
pos.len	etc/lua/pos.lua	/^function pos.len(pos1, pos2)$/;"	f
pos.new	etc/lua/pos.lua	/^function pos.new(x, y, z)$/;"	f
pst._	etc/lua/pst.lua	/^function pst._(url, msg_id, prm)$/;"	f
pst.gui	etc/lua/pst.lua	/^function pst.gui(id, msg_id, prm)$/;"	f
pst.parent__	etc/lua/pst.lua	/^function pst.parent__(t_id, p_id, z, p_pos)$/;"	f
pst.parent__map	etc/lua/pst.lua	/^function pst.parent__map(t_id, z)$/;"	f
pst.pos__	etc/lua/pst.lua	/^function pst.pos__(p_id, p_pos)$/;"	f
pst.script	etc/lua/pst.lua	/^function pst.script(id, msg_id, prm)$/;"	f
pst.sprite	etc/lua/pst.lua	/^function pst.sprite(id, msg_id, prm)$/;"	f
pst.z__	etc/lua/pst.lua	/^function pst.z__(p_id, z)$/;"	f
rnd.ar	etc/lua/rnd.lua	/^function rnd.ar(ar)$/;"	f
rnd.by_f	etc/lua/rnd.lua	/^function rnd.by_f(f) -- f: 0 - 1$/;"	f
rnd.by_p	etc/lua/rnd.lua	/^function rnd.by_p(i)$/;"	f
rnd.int	etc/lua/rnd.lua	/^function rnd.int(min, max, excld)$/;"	f
rnd.int_pad	etc/lua/rnd.lua	/^function rnd.int_pad(p_max)$/;"	f
str._2_int	etc/lua/str.lua	/^function str._2_int(str)$/;"	f
tile.__	etc/lua/tile.lua	/^function tile.__(tilemap_url, t_layer, x, y, p_tile)$/;"	f
ts.ar	etc/lua/ts.lua	/^function ts.ar(p_ts)$/;"	f
ts.now	etc/lua/ts.lua	/^function ts.now()$/;"	f
ts.str	etc/lua/ts.lua	/^function ts.str(p_ts)$/;"	f
u.dec_loop	etc/lua/u.lua	/^function u.dec_loop(val, max, min)$/;"	f
u.dec_stop	etc/lua/u.lua	/^function u.dec_stop(val, max, min)$/;"	f
u.eq	etc/lua/u.lua	/^function u.eq(val1, val2)$/;"	f
u.get_dcl_len	etc/lua/u.lua	/^function u.get_dcl_len(speed, accl)$/;"	f
u.inc_loop	etc/lua/u.lua	/^function u.inc_loop(val, max, min)$/;"	f
u.inc_stop	etc/lua/u.lua	/^function u.inc_stop(val, max)$/;"	f
u.is_emp	etc/lua/u.lua	/^function u.is_emp(val)$/;"	f
u.is_rng	etc/lua/u.lua	/^function u.is_rng(idx, p_ar) -- ar: {min, max} -- old$/;"	f
u.pls_loop	etc/lua/u.lua	/^function u.pls_loop(val1, val2, max, min)$/;"	f
u.rad_2_vec	etc/lua/u.lua	/^function u.rad_2_vec(rad)$/;"	f
u.rad_diff	etc/lua/u.lua	/^function u.rad_diff(vec1, vec2)$/;"	f
u.vec_2_rad	etc/lua/u.lua	/^function u.vec_2_rad(vec)$/;"	f
u.x_by_all_w	etc/lua/u.lua	/^function u.x_by_all_w(idx, max, wa)$/;"	f
u.x_by_itm_w	etc/lua/u.lua	/^function u.x_by_itm_w(idx, max, w)$/;"	f
url._	etc/lua/url.lua	/^function url._(p_id, cmp)$/;"	f
url.main	etc/lua/url.lua	/^function url.main(id, cmp)$/;"	f
vec.clone	etc/lua/vec.lua	/^function vec.clone(p_vec)$/;"	f
vec.len	etc/lua/vec.lua	/^function vec.len(vec1, vec2)$/;"	f
vec.n	etc/lua/vec.lua	/^function vec.n(x, y, z)$/;"	f
vec.new	etc/lua/vec.lua	/^function vec.new(x, y, z) -- alias$/;"	f
vec.unit	etc/lua/vec.lua	/^function vec.unit(p_vec)$/;"	f
xy._2_idx	etc/lua/xy.lua	/^function xy._2_idx(p_xy, xy_size)$/;"	f
xy._2_pos	etc/lua/xy.lua	/^function xy._2_pos(p_xy, xy_size, pitch)$/;"	f
xy.idx_2_xy	etc/lua/xy.lua	/^function xy.idx_2_xy(idx, xy_size)$/;"	f
